Date,Away,Away_Goals,Home,Home_Goals,MOV,Away_B2B,Home_B2B,Away_ELO,Home_ELO
2021-01-13,St. Louis Blues,4,Colorado Avalanche,1,3,0,0,1500,1500
2021-01-13,Vancouver Canucks,5,Edmonton Oilers,3,2,0,0,1500,1500
2021-01-13,Pittsburgh Penguins,3,Philadelphia Flyers,6,3,0,0,1500,1500
2021-01-13,Chicago Blackhawks,1,Tampa Bay Lightning,5,4,0,0,1500,1500
2021-01-13,Montreal Canadiens,4,Toronto Maple Leafs,5,1,0,0,1500,1500
2021-01-14,San Jose Sharks,4,Arizona Coyotes,3,1,0,0,1500,1500
2021-01-14,Washington Capitals,6,Buffalo Sabres,4,2,0,0,1500,1500
2021-01-14,Carolina Hurricanes,3,Detroit Red Wings,0,3,0,0,1500,1500
2021-01-14,Vancouver Canucks,2,Edmonton Oilers,5,3,1,1,1500,1500
2021-01-14,Minnesota Wild,4,Los Angeles Kings,3,1,0,0,1500,1500
2021-01-14,Boston Bruins,3,New Jersey Devils,2,1,0,0,1500,1500
2021-01-14,Columbus Blue Jackets,1,Nashville Predators,3,2,0,0,1500,1500
2021-01-14,New York Islanders,4,New York Rangers,0,4,0,0,1500,1500
2021-01-14,Anaheim Ducks,2,Vegas Golden Knights,5,3,0,0,1500,1500
2021-01-14,Calgary Flames,3,Winnipeg Jets,4,1,0,0,1500,1500
2021-01-15,Washington Capitals,2,Buffalo Sabres,1,1,1,1,1500,1500
2021-01-15,St. Louis Blues,0,Colorado Avalanche,8,8,0,0,1500,1500
2021-01-15,Toronto Maple Leafs,3,Ottawa Senators,5,2,0,0,1500,1500
2021-01-15,Pittsburgh Penguins,2,Philadelphia Flyers,5,3,0,0,1500,1500
2021-01-15,Chicago Blackhawks,2,Tampa Bay Lightning,5,3,0,0,1500,1500
2021-01-16,San Jose Sharks,3,Arizona Coyotes,5,2,0,0,1500,1500
2021-01-16,Vancouver Canucks,0,Calgary Flames,3,3,0,0,1500,1500
2021-01-16,Carolina Hurricanes,2,Detroit Red Wings,4,2,0,0,1500,1500
2021-01-16,Montreal Canadiens,5,Edmonton Oilers,1,4,0,0,1500,1500
2021-01-16,Minnesota Wild,4,Los Angeles Kings,3,1,0,0,1500,1500
2021-01-16,Boston Bruins,1,New Jersey Devils,2,1,0,0,1500,1500
2021-01-16,Columbus Blue Jackets,2,Nashville Predators,5,3,0,0,1500,1500
2021-01-16,New York Islanders,0,New York Rangers,5,5,0,0,1500,1500
2021-01-16,Toronto Maple Leafs,3,Ottawa Senators,2,1,1,1,1500,1500
2021-01-16,Anaheim Ducks,1,Vegas Golden Knights,2,1,0,0,1500,1500
2021-01-17,Chicago Blackhawks,2,Florida Panthers,5,3,0,0,1500,1500
2021-01-17,Washington Capitals,3,Pittsburgh Penguins,4,1,0,0,1500,1500
2021-01-18,Minnesota Wild,0,Anaheim Ducks,1,1,0,0,1500,1500
2021-01-18,Vancouver Canucks,2,Calgary Flames,5,3,0,0,1500,1500
2021-01-18,Columbus Blue Jackets,3,Detroit Red Wings,2,1,0,0,1500,1500
2021-01-18,Montreal Canadiens,3,Edmonton Oilers,1,2,0,0,1500,1500
2021-01-18,Carolina Hurricanes,4,Nashville Predators,2,2,0,0,1500,1500
2021-01-18,Boston Bruins,0,New York Islanders,1,1,0,0,1500,1500
2021-01-18,Buffalo Sabres,6,Philadelphia Flyers,1,5,0,0,1500,1500
2021-01-18,San Jose Sharks,4,St. Louis Blues,5,1,0,0,1500,1500
2021-01-18,Winnipeg Jets,1,Toronto Maple Leafs,3,2,0,0,1500,1500
2021-01-18,Arizona Coyotes,2,Vegas Golden Knights,4,2,0,0,1500,1500
2021-01-19,Columbus Blue Jackets,2,Detroit Red Wings,3,1,1,1,1500,1500
2021-01-19,Chicago Blackhawks,4,Florida Panthers,5,1,0,0,1500,1500
2021-01-19,Colorado Avalanche,3,Los Angeles Kings,2,1,0,0,1500,1500
2021-01-19,New Jersey Devils,4,New York Rangers,3,1,0,0,1500,1500
2021-01-19,Winnipeg Jets,4,Ottawa Senators,3,1,1,0,1500,1500
2021-01-19,Buffalo Sabres,0,Philadelphia Flyers,3,3,1,1,1500,1500
2021-01-19,Washington Capitals,4,Pittsburgh Penguins,5,1,0,0,1500,1500
2021-01-20,Minnesota Wild,3,Anaheim Ducks,2,1,0,0,1500,1500
2021-01-20,San Jose Sharks,2,St. Louis Blues,1,1,0,0,1500,1500
2021-01-20,Edmonton Oilers,3,Toronto Maple Leafs,1,2,0,0,1500,1500
2021-01-20,Montreal Canadiens,5,Vancouver Canucks,6,1,0,0,1500,1500
2021-01-20,Arizona Coyotes,2,Vegas Golden Knights,5,3,0,0,1500,1500
2021-01-21,Philadelphia Flyers,4,Boston Bruins,5,1,0,0,1500,1500
2021-01-21,Tampa Bay Lightning,3,Columbus Blue Jackets,2,1,0,0,1500,1500
2021-01-21,Colorado Avalanche,2,Los Angeles Kings,4,2,0,0,1500,1500
2021-01-21,New Jersey Devils,1,New York Islanders,4,3,0,0,1500,1500
2021-01-21,Winnipeg Jets,4,Ottawa Senators,1,3,0,0,1500,1500
2021-01-21,Montreal Canadiens,7,Vancouver Canucks,3,4,1,1,1500,1500
2021-01-22,Colorado Avalanche,3,Anaheim Ducks,2,1,1,0,1500,1500
2021-01-22,Vegas Golden Knights,2,Arizona Coyotes,5,3,0,0,1500,1500
2021-01-22,Detroit Red Wings,1,Chicago Blackhawks,4,3,0,0,1500,1500
2021-01-22,Nashville Predators,0,Dallas Stars,7,7,0,0,1500,1500
2021-01-22,San Jose Sharks,1,Minnesota Wild,4,3,0,0,1500,1500
2021-01-22,New York Rangers,3,Pittsburgh Penguins,4,1,0,0,1500,1500
2021-01-22,Edmonton Oilers,2,Toronto Maple Leafs,4,2,0,0,1500,1500
2021-01-22,Buffalo Sabres,3,Washington Capitals,4,1,0,0,1500,1500
2021-01-23,Philadelphia Flyers,1,Boston Bruins,6,5,0,0,1500,1500
2021-01-23,Tampa Bay Lightning,2,Columbus Blue Jackets,5,3,0,0,1500,1500
2021-01-23,Los Angeles Kings,2,St. Louis Blues,4,2,0,0,1500,1500
2021-01-23,Montreal Canadiens,5,Vancouver Canucks,2,3,0,0,1500,1500
2021-01-23,Ottawa Senators,3,Winnipeg Jets,6,3,0,0,1500,1500
2021-01-24,Colorado Avalanche,1,Anaheim Ducks,3,2,0,0,1500,1500
2021-01-24,Vegas Golden Knights,1,Arizona Coyotes,0,1,0,0,1500,1500
2021-01-24,Toronto Maple Leafs,3,Calgary Flames,2,1,0,0,1500,1500
2021-01-24,Detroit Red Wings,2,Chicago Blackhawks,6,4,0,0,1500,1500
2021-01-24,Nashville Predators,2,Dallas Stars,3,1,0,0,1500,1500
2021-01-24,San Jose Sharks,5,Minnesota Wild,3,2,0,0,1500,1500
2021-01-24,New York Islanders,0,New Jersey Devils,2,2,0,0,1500,1500
2021-01-24,New York Rangers,2,Pittsburgh Penguins,3,1,0,0,1500,1500
2021-01-24,Los Angeles Kings,6,St. Louis Blues,3,3,1,1,1500,1500
2021-01-24,Edmonton Oilers,4,Winnipeg Jets,3,1,0,1,1500,1500
2021-01-24,Buffalo Sabres,4,Washington Capitals,3,1,0,0,1500,1500
2021-01-25,Ottawa Senators,1,Vancouver Canucks,7,6,0,0,1500,1500
2021-01-26,Anaheim Ducks,1,Arizona Coyotes,0,1,0,0,1500,1500
2021-01-26,Pittsburgh Penguins,2,Boston Bruins,3,1,0,0,1500,1500
2021-01-26,New York Rangers,2,Buffalo Sabres,3,1,0,0,1500,1500
2021-01-26,Florida Panthers,4,Columbus Blue Jackets,3,1,0,0,1500,1500
2021-01-26,Toronto Maple Leafs,4,Calgary Flames,3,1,0,0,1500,1500
2021-01-26,San Jose Sharks,3,Colorado Avalanche,7,4,0,0,1500,1500
2021-01-26,Detroit Red Wings,1,Dallas Stars,2,1,0,0,1500,1500
2021-01-26,Los Angeles Kings,2,Minnesota Wild,1,1,0,0,1500,1500
2021-01-26,Philadelphia Flyers,5,New Jersey Devils,3,2,0,0,1500,1500
2021-01-26,Chicago Blackhawks,2,Nashville Predators,3,1,0,0,1500,1500
2021-01-26,St. Louis Blues,5,Vegas Golden Knights,4,1,0,0,1500,1500
2021-01-26,Edmonton Oilers,4,Winnipeg Jets,6,2,0,0,1500,1500
2021-01-26,New York Islanders,2,Washington Capitals,3,1,0,0,1500,1500
2021-01-27,Chicago Blackhawks,1,Nashville Predators,2,1,1,1,1500,1500
2021-01-27,Ottawa Senators,1,Vancouver Canucks,5,4,0,0,1500,1500
2021-01-28,Anaheim Ducks,2,Arizona Coyotes,3,1,0,0,1500,1500
2021-01-28,Pittsburgh Penguins,1,Boston Bruins,4,3,0,0,1500,1500
2021-01-28,New York Rangers,3,Buffalo Sabres,2,1,0,0,1500,1500
2021-01-28,Tampa Bay Lightning,0,Carolina Hurricanes,1,1,0,0,1500,1500
2021-01-28,Florida Panthers,2,Columbus Blue Jackets,3,1,0,0,1500,1500
2021-01-28,San Jose Sharks,0,Colorado Avalanche,3,3,0,0,1500,1500
2021-01-28,Detroit Red Wings,3,Dallas Stars,7,4,0,0,1500,1500
2021-01-28,Toronto Maple Leafs,4,Edmonton Oilers,3,1,0,0,1500,1500
2021-01-28,Los Angeles Kings,3,Minnesota Wild,5,2,0,0,1500,1500
2021-01-28,Calgary Flames,2,Montreal Canadiens,4,2,0,0,1500,1500
2021-01-28,Philadelphia Flyers,3,New Jersey Devils,1,2,0,0,1500,1500
2021-01-28,Ottawa Senators,1,Vancouver Canucks,4,3,1,1,1500,1500
2021-01-28,New York Islanders,3,Washington Capitals,6,3,0,0,1500,1500
2021-01-29,Columbus Blue Jackets,2,Chicago Blackhawks,1,1,1,0,1500,1500
2021-01-30,St. Louis Blues,6,Anaheim Ducks,1,5,0,0,1500,1500
2021-01-30,New Jersey Devils,3,Buffalo Sabres,4,1,0,0,1500,1500
2021-01-30,Dallas Stars,1,Carolina Hurricanes,4,3,0,0,1500,1500
2021-01-30,Florida Panthers,3,Detroit Red Wings,2,1,0,0,1500,1500
2021-01-30,Toronto Maple Leafs,3,Edmonton Oilers,4,1,0,0,1500,1500
2021-01-30,Colorado Avalanche,5,Minnesota Wild,1,4,0,0,1500,1500
2021-01-30,Calgary Flames,2,Montreal Canadiens,0,2,0,0,1500,1500
2021-01-30,Pittsburgh Penguins,5,New York Rangers,4,1,0,0,1500,1500
2021-01-30,New York Islanders,2,Philadelphia Flyers,3,1,0,0,1500,1500
2021-01-30,Nashville Predators,3,Tampa Bay Lightning,4,1,0,0,1500,1500
2021-01-30,Vancouver Canucks,4,Winnipeg Jets,1,3,0,0,1500,1500
2021-01-30,Boston Bruins,3,Washington Capitals,4,1,0,0,1500,1500
2021-01-31,St. Louis Blues,4,Anaheim Ducks,1,3,1,1,1500,1500
2021-01-31,New Jersey Devils,5,Buffalo Sabres,3,2,1,1,1500,1500
2021-01-31,Dallas Stars,3,Carolina Hurricanes,4,1,1,1,1500,1500
2021-01-31,Columbus Blue Jackets,1,Chicago Blackhawks,3,2,0,0,1500,1500
2021-01-31,Florida Panthers,3,Detroit Red Wings,2,1,1,1,1500,1500
2021-01-31,Ottawa Senators,5,Edmonton Oilers,8,3,0,1,1500,1500
2021-01-31,Colorado Avalanche,3,Minnesota Wild,4,1,1,1,1500,1500
2021-01-31,New York Islanders,3,Philadelphia Flyers,4,1,1,1,1500,1500
2021-02-01,Vancouver Canucks,2,Montreal Canadiens,6,4,0,0,1500,1500
2021-02-01,Pittsburgh Penguins,1,New York Rangers,3,2,0,0,1500,1500
2021-02-01,Nashville Predators,2,Tampa Bay Lightning,5,3,0,0,1500,1500
2021-02-01,Calgary Flames,4,Winnipeg Jets,3,1,0,0,1500,1500
2021-02-01,Boston Bruins,5,Washington Capitals,3,2,0,0,1500,1500
2021-02-02,Dallas Stars,6,Columbus Blue Jackets,3,3,0,0,1500,1500
2021-02-02,Carolina Hurricanes,4,Chicago Blackhawks,3,1,0,0,1500,1500
2021-02-02,Minnesota Wild,1,Colorado Avalanche,2,1,0,0,1500,1500
2021-02-02,Ottawa Senators,2,Edmonton Oilers,4,2,0,0,1500,1500
2021-02-02,Anaheim Ducks,3,Los Angeles Kings,1,2,0,0,1500,1500
2021-02-02,Vancouver Canucks,3,Montreal Canadiens,5,2,1,1,1500,1500
2021-02-02,Arizona Coyotes,3,St. Louis Blues,4,1,0,0,1500,1500
2021-02-02,Calgary Flames,2,Winnipeg Jets,3,1,1,1,1500,1500
2021-02-03,Boston Bruins,4,Philadelphia Flyers,3,1,0,0,1500,1500
2021-02-03,Detroit Red Wings,1,Tampa Bay Lightning,5,4,0,0,1500,1500
2021-02-04,Dallas Stars,3,Columbus Blue Jackets,4,1,0,0,1500,1500
2021-02-04,Carolina Hurricanes,4,Chicago Blackhawks,6,2,0,0,1500,1500
2021-02-04,Nashville Predators,6,Florida Panthers,5,1,0,0,1500,1500
2021-02-04,Ottawa Senators,3,Montreal Canadiens,2,1,0,0,1500,1500
2021-02-04,Washington Capitals,2,New York Rangers,4,2,0,0,1500,1500
2021-02-04,Arizona Coyotes,4,St. Louis Blues,3,1,0,0,1500,1500
2021-02-04,Vancouver Canucks,3,Toronto Maple Leafs,7,4,0,0,1500,1500
2021-02-04,Calgary Flames,1,Winnipeg Jets,4,3,0,0,1500,1500
2021-02-05,San Jose Sharks,5,Anaheim Ducks,4,1,0,0,1500,1500
2021-02-05,Nashville Predators,1,Florida Panthers,2,1,1,1,1500,1500
2021-02-05,Boston Bruins,2,Philadelphia Flyers,1,1,0,0,1500,1500
2021-02-05,Detroit Red Wings,1,Tampa Bay Lightning,3,2,0,0,1500,1500
2021-02-05,Los Angeles Kings,2,Vegas Golden Knights,5,3,0,0,1500,1500
2021-02-06,San Jose Sharks,1,Anaheim Ducks,2,1,1,1,1500,1500
2021-02-06,Edmonton Oilers,4,Calgary Flames,6,2,0,0,1500,1500
2021-02-06,Pittsburgh Penguins,3,New York Islanders,4,1,0,0,1500,1500
2021-02-06,Montreal Canadiens,2,Ottawa Senators,1,1,0,0,1500,1500
2021-02-06,Arizona Coyotes,3,St. Louis Blues,1,2,0,0,1500,1500
2021-02-06,Vancouver Canucks,1,Toronto Maple Leafs,5,4,0,0,1500,1500
2021-02-07,Carolina Hurricanes,6,Columbus Blue Jackets,5,1,0,0,1500,1500
2021-02-07,Chicago Blackhawks,2,Dallas Stars,1,1,0,0,1500,1500
2021-02-07,Detroit Red Wings,4,Florida Panthers,1,3,0,0,1500,1500
2021-02-07,Los Angeles Kings,3,Vegas Golden Knights,4,1,0,0,1500,1500
2021-02-07,Philadelphia Flyers,7,Washington Capitals,4,3,0,0,1500,1500
2021-02-08,Carolina Hurricanes,2,Columbus Blue Jackets,3,1,1,1,1500,1500
2021-02-08,Tampa Bay Lightning,4,Nashville Predators,1,3,0,0,1500,1500
2021-02-08,New York Islanders,2,New York Rangers,0,2,0,0,1500,1500
2021-02-08,Edmonton Oilers,3,Ottawa Senators,1,2,0,0,1500,1500
2021-02-08,Arizona Coyotes,4,St. Louis Blues,3,1,0,0,1500,1500
2021-02-08,Vancouver Canucks,1,Toronto Maple Leafs,3,2,0,0,1500,1500
2021-02-09,Winnipeg Jets,2,Calgary Flames,3,1,0,0,1500,1500
2021-02-09,Chicago Blackhawks,2,Dallas Stars,1,1,0,0,1500,1500
2021-02-09,Detroit Red Wings,1,Florida Panthers,2,1,0,0,1500,1500
2021-02-09,San Jose Sharks,4,Los Angeles Kings,3,1,0,0,1500,1500
2021-02-09,Tampa Bay Lightning,6,Nashville Predators,1,5,1,1,1500,1500
2021-02-09,Edmonton Oilers,3,Ottawa Senators,2,1,1,1,1500,1500
2021-02-09,Anaheim Ducks,4,Vegas Golden Knights,5,1,0,0,1500,1500
2021-02-10,Toronto Maple Leafs,4,Montreal Canadiens,2,2,0,0,1500,1500
2021-02-10,Boston Bruins,3,New York Rangers,2,1,0,0,1500,1500
2021-02-11,Columbus Blue Jackets,6,Chicago Blackhawks,5,1,0,0,1500,1500
2021-02-11,Carolina Hurricanes,5,Dallas Stars,3,2,0,0,1500,1500
2021-02-11,Tampa Bay Lightning,2,Florida Panthers,5,3,0,0,1500,1500
2021-02-11,San Jose Sharks,2,Los Angeles Kings,6,4,0,0,1500,1500
2021-02-11,Edmonton Oilers,3,Montreal Canadiens,0,3,0,1,1500,1500
2021-02-11,Detroit Red Wings,2,Nashville Predators,3,1,0,0,1500,1500
2021-02-11,Pittsburgh Penguins,4,New York Islanders,3,1,0,0,1500,1500
2021-02-11,Calgary Flames,3,Vancouver Canucks,1,2,0,0,1500,1500
2021-02-11,Anaheim Ducks,1,Vegas Golden Knights,0,1,0,0,1500,1500
2021-02-11,Ottawa Senators,1,Winnipeg Jets,5,4,0,0,1500,1500
2021-02-12,St. Louis Blues,4,Arizona Coyotes,1,3,0,0,1500,1500
2021-02-12,Boston Bruins,1,New York Rangers,0,1,0,0,1500,1500
2021-02-13,St. Louis Blues,5,Arizona Coyotes,4,1,1,1,1500,1500
2021-02-13,Columbus Blue Jackets,2,Chicago Blackhawks,3,1,0,0,1500,1500
2021-02-13,Carolina Hurricanes,4,Dallas Stars,3,1,0,0,1500,1500
2021-02-13,Tampa Bay Lightning,6,Florida Panthers,1,5,0,0,1500,1500
2021-02-13,Detroit Red Wings,4,Nashville Predators,2,2,0,0,1500,1500
2021-02-13,Boston Bruins,2,New York Islanders,4,2,1,0,1500,1500
2021-02-13,Vegas Golden Knights,3,San Jose Sharks,1,2,0,0,1500,1500
2021-02-13,Montreal Canadiens,2,Toronto Maple Leafs,1,1,0,0,1500,1500
2021-02-13,Calgary Flames,1,Vancouver Canucks,3,2,0,0,1500,1500
2021-02-13,Ottawa Senators,2,Winnipeg Jets,1,1,0,0,1500,1500
2021-02-14,Washington Capitals,3,Pittsburgh Penguins,6,3,0,0,1500,1500
2021-02-14,Colorado Avalanche,0,Vegas Golden Knights,1,1,0,1,1500,1500
2021-02-15,St. Louis Blues,0,Arizona Coyotes,1,1,0,0,1500,1500
2021-02-15,New York Islanders,3,Buffalo Sabres,1,2,0,0,1500,1500
2021-02-15,Columbus Blue Jackets,3,Carolina Hurricanes,7,4,0,0,1500,1500
2021-02-15,Chicago Blackhawks,3,Detroit Red Wings,2,1,0,0,1500,1500
2021-02-15,Winnipeg Jets,6,Edmonton Oilers,5,1,0,0,1500,1500
2021-02-15,Anaheim Ducks,2,San Jose Sharks,3,1,0,0,1500,1500
2021-02-15,Florida Panthers,6,Tampa Bay Lightning,4,2,0,0,1500,1500
2021-02-15,Ottawa Senators,6,Toronto Maple Leafs,5,1,0,0,1500,1500
2021-02-15,Calgary Flames,4,Vancouver Canucks,3,1,0,0,1500,1500
2021-02-16,New York Islanders,3,Buffalo Sabres,0,3,1,1,1500,1500
2021-02-16,Minnesota Wild,0,Los Angeles Kings,4,4,0,0,1500,1500
2021-02-16,New Jersey Devils,5,New York Rangers,2,3,0,0,1500,1500
2021-02-16,Washington Capitals,3,Pittsburgh Penguins,1,2,0,0,1500,1500
2021-02-16,Colorado Avalanche,3,Vegas Golden Knights,2,1,0,0,1500,1500
2021-02-17,Florida Panthers,4,Carolina Hurricanes,3,1,0,0,1500,1500
2021-02-17,Vancouver Canucks,5,Calgary Flames,1,4,0,0,1500,1500
2021-02-17,Chicago Blackhawks,2,Detroit Red Wings,0,2,0,0,1500,1500
2021-02-17,Winnipeg Jets,2,Edmonton Oilers,3,1,0,0,1500,1500
2021-02-17,Ottawa Senators,1,Toronto Maple Leafs,2,1,0,0,1500,1500
2021-02-18,Minnesota Wild,3,Anaheim Ducks,1,2,0,0,1500,1500
2021-02-18,Los Angeles Kings,3,Arizona Coyotes,2,1,0,0,1500,1500
2021-02-18,New Jersey Devils,3,Boston Bruins,2,1,0,0,1500,1500
2021-02-18,Nashville Predators,0,Columbus Blue Jackets,3,3,0,0,1500,1500
2021-02-18,New York Rangers,3,Philadelphia Flyers,2,1,0,0,1500,1500
2021-02-18,New York Islanders,1,Pittsburgh Penguins,4,3,0,0,1500,1500
2021-02-18,San Jose Sharks,2,St. Louis Blues,3,1,0,0,1500,1500
2021-02-18,Ottawa Senators,3,Toronto Maple Leafs,7,4,1,1,1500,1500
2021-02-18,Buffalo Sabres,1,Washington Capitals,3,2,0,0,1500,1500
2021-02-19,Chicago Blackhawks,3,Carolina Hurricanes,5,2,0,0,1500,1500
2021-02-19,Edmonton Oilers,2,Calgary Flames,1,1,0,0,1500,1500
2021-02-19,Florida Panthers,7,Detroit Red Wings,2,5,0,0,1500,1500
2021-02-19,Winnipeg Jets,2,Vancouver Canucks,0,2,0,0,1500,1500
2021-02-20,Minnesota Wild,5,Anaheim Ducks,1,4,0,0,1500,1500
2021-02-20,Los Angeles Kings,4,Arizona Coyotes,2,2,0,0,1500,1500
2021-02-20,Tampa Bay Lightning,0,Carolina Hurricanes,4,4,0,1,1500,1500
2021-02-20,Nashville Predators,4,Columbus Blue Jackets,2,2,0,0,1500,1500
2021-02-20,Vegas Golden Knights,2,Colorado Avalanche,3,1,0,0,1500,1500
2021-02-20,Florida Panthers,1,Detroit Red Wings,2,1,1,1,1500,1500
2021-02-20,Calgary Flames,1,Edmonton Oilers,7,6,1,1,1500,1500
2021-02-20,Toronto Maple Leafs,5,Montreal Canadiens,3,2,0,0,1500,1500
2021-02-20,Buffalo Sabres,3,New Jersey Devils,2,1,0,0,1500,1500
2021-02-20,New York Islanders,2,Pittsburgh Penguins,3,1,0,0,1500,1500
2021-02-20,San Jose Sharks,5,St. Louis Blues,4,1,0,0,1500,1500
2021-02-20,New York Rangers,4,Washington Capitals,1,3,0,0,1500,1500
2021-02-21,Philadelphia Flyers,3,Boston Bruins,7,4,0,0,1500,1500
2021-02-21,Montreal Canadiens,2,Ottawa Senators,3,1,1,0,1500,1500
2021-02-21,Winnipeg Jets,4,Vancouver Canucks,3,1,0,0,1500,1500
2021-02-21,New Jersey Devils,3,Washington Capitals,4,1,1,1,1500,1500
2021-02-22,Anaheim Ducks,3,Arizona Coyotes,4,1,0,0,1500,1500
2021-02-22,Tampa Bay Lightning,4,Carolina Hurricanes,2,2,0,0,1500,1500
2021-02-22,Vegas Golden Knights,3,Colorado Avalanche,0,3,0,0,1500,1500
2021-02-22,Dallas Stars,1,Florida Panthers,3,2,0,0,1500,1500
2021-02-22,Buffalo Sabres,2,New York Islanders,3,1,0,0,1500,1500
2021-02-22,Minnesota Wild,6,San Jose Sharks,2,4,0,0,1500,1500
2021-02-22,Los Angeles Kings,3,St. Louis Blues,0,3,0,0,1500,1500
2021-02-22,Calgary Flames,3,Toronto Maple Leafs,0,3,0,0,1500,1500
2021-02-23,Chicago Blackhawks,6,Columbus Blue Jackets,5,1,0,0,1500,1500
2021-02-23,Nashville Predators,2,Detroit Red Wings,0,2,0,0,1500,1500
2021-02-23,Buffalo Sabres,4,New Jersey Devils,1,3,1,0,1500,1500
2021-02-23,Montreal Canadiens,4,Ottawa Senators,5,1,0,0,1500,1500
2021-02-23,Edmonton Oilers,4,Vancouver Canucks,3,1,0,0,1500,1500
2021-02-23,Pittsburgh Penguins,3,Washington Capitals,2,1,0,0,1500,1500
2021-02-24,Anaheim Ducks,3,Arizona Coyotes,4,1,0,0,1500,1500
2021-02-24,Minnesota Wild,6,Colorado Avalanche,2,4,0,0,1500,1500
2021-02-24,Dallas Stars,3,Florida Panthers,0,3,0,0,1500,1500
2021-02-24,New York Rangers,3,Philadelphia Flyers,4,1,0,0,1500,1500
2021-02-24,Los Angeles Kings,2,St. Louis Blues,1,1,0,0,1500,1500
2021-02-24,Carolina Hurricanes,0,Tampa Bay Lightning,3,3,0,0,1500,1500
2021-02-24,Calgary Flames,1,Toronto Maple Leafs,2,1,0,0,1500,1500
2021-02-25,New Jersey Devils,4,Buffalo Sabres,3,1,0,0,1500,1500
2021-02-25,Chicago Blackhawks,2,Columbus Blue Jackets,0,2,0,0,1500,1500
2021-02-25,Nashville Predators,2,Detroit Red Wings,5,3,0,0,1500,1500
2021-02-25,Dallas Stars,2,Florida Panthers,3,1,1,1,1500,1500
2021-02-25,Boston Bruins,2,New York Islanders,7,5,0,0,1500,1500
2021-02-25,Calgary Flames,1,Ottawa Senators,6,5,1,0,1500,1500
2021-02-25,Carolina Hurricanes,1,Tampa Bay Lightning,3,2,1,1,1500,1500
2021-02-25,Edmonton Oilers,3,Vancouver Canucks,0,3,0,0,1500,1500
2021-02-25,Montreal Canadiens,3,Winnipeg Jets,6,3,0,0,1500,1500
2021-02-25,Pittsburgh Penguins,2,Washington Capitals,5,3,0,0,1500,1500
2021-02-26,Colorado Avalanche,3,Arizona Coyotes,2,1,0,0,1500,1500
2021-02-26,Los Angeles Kings,1,Minnesota Wild,3,2,0,0,1500,1500
2021-02-26,Boston Bruins,2,New York Rangers,6,4,1,0,1500,1500
2021-02-27,Vegas Golden Knights,3,Anaheim Ducks,2,1,0,0,1500,1500
2021-02-27,Colorado Avalanche,6,Arizona Coyotes,2,4,1,1,1500,1500
2021-02-27,Philadelphia Flyers,3,Buffalo Sabres,0,3,0,0,1500,1500
2021-02-27,Detroit Red Wings,5,Chicago Blackhawks,3,2,0,0,1500,1500
2021-02-27,Toronto Maple Leafs,4,Edmonton Oilers,0,4,0,0,1500,1500
2021-02-27,Carolina Hurricanes,4,Florida Panthers,3,1,0,0,1500,1500
2021-02-27,Los Angeles Kings,3,Minnesota Wild,4,1,1,1,1500,1500
2021-02-27,Washington Capitals,5,New Jersey Devils,2,3,0,0,1500,1500
2021-02-27,Columbus Blue Jackets,1,Nashville Predators,2,1,0,0,1500,1500
2021-02-27,Pittsburgh Penguins,4,New York Islanders,3,1,0,0,1500,1500
2021-02-27,Calgary Flames,6,Ottawa Senators,3,3,0,0,1500,1500
2021-02-27,St. Louis Blues,7,San Jose Sharks,6,1,0,0,1500,1500
2021-02-27,Dallas Stars,0,Tampa Bay Lightning,5,5,0,0,1500,1500
2021-02-27,Montreal Canadiens,1,Winnipeg Jets,2,1,0,0,1500,1500
2021-02-28,Philadelphia Flyers,3,Buffalo Sabres,0,3,1,1,1500,1500
2021-02-28,Detroit Red Wings,2,Chicago Blackhawks,7,5,1,1,1500,1500
2021-02-28,Washington Capitals,3,New Jersey Devils,2,1,1,1,1500,1500
2021-02-28,Columbus Blue Jackets,1,Nashville Predators,3,2,1,1,1500,1500
2021-02-28,Pittsburgh Penguins,0,New York Islanders,2,2,1,1,1500,1500
2021-02-28,Boston Bruins,4,New York Rangers,1,3,0,0,1500,1500
2021-03-01,St. Louis Blues,5,Anaheim Ducks,4,1,0,0,1500,1500
2021-03-01,Toronto Maple Leafs,3,Edmonton Oilers,0,3,0,0,1500,1500
2021-03-01,Carolina Hurricanes,3,Florida Panthers,2,1,0,0,1500,1500
2021-03-01,Calgary Flames,1,Ottawa Senators,5,4,0,0,1500,1500
2021-03-01,Colorado Avalanche,2,San Jose Sharks,6,4,0,0,1500,1500
2021-03-01,Minnesota Wild,4,Vegas Golden Knights,5,1,0,0,1500,1500
2021-03-01,Vancouver Canucks,4,Winnipeg Jets,0,4,0,0,1500,1500
2021-03-02,Detroit Red Wings,1,Columbus Blue Jackets,4,3,0,0,1500,1500
2021-03-02,Tampa Bay Lightning,2,Dallas Stars,0,2,0,0,1500,1500
2021-03-02,Ottawa Senators,1,Montreal Canadiens,3,2,1,0,1500,1500
2021-03-02,New York Islanders,2,New Jersey Devils,1,1,0,0,1500,1500
2021-03-02,Carolina Hurricanes,4,Nashville Predators,2,2,1,0,1500,1500
2021-03-02,Buffalo Sabres,2,New York Rangers,3,1,0,0,1500,1500
2021-03-02,Philadelphia Flyers,2,Pittsburgh Penguins,5,3,0,0,1500,1500
2021-03-02,Vancouver Canucks,2,Winnipeg Jets,5,3,1,1,1500,1500
2021-03-03,St. Louis Blues,3,Anaheim Ducks,2,1,0,0,1500,1500
2021-03-03,Washington Capitals,2,Boston Bruins,1,1,0,0,1500,1500
2021-03-03,Toronto Maple Leafs,6,Edmonton Oilers,1,5,0,0,1500,1500
2021-03-03,Arizona Coyotes,3,Los Angeles Kings,2,1,0,0,1500,1500
2021-03-03,Colorado Avalanche,4,San Jose Sharks,0,4,0,0,1500,1500
2021-03-03,Minnesota Wild,1,Vegas Golden Knights,5,4,0,0,1500,1500
2021-03-04,Detroit Red Wings,2,Carolina Hurricanes,5,3,0,0,1500,1500
2021-03-04,Ottawa Senators,3,Calgary Flames,7,4,0,0,1500,1500
2021-03-04,Tampa Bay Lightning,3,Chicago Blackhawks,2,1,0,0,1500,1500
2021-03-04,Columbus Blue Jackets,3,Dallas Stars,2,1,0,0,1500,1500
2021-03-04,Winnipeg Jets,4,Montreal Canadiens,3,1,0,0,1500,1500
2021-03-04,New York Rangers,6,New Jersey Devils,1,5,0,0,1500,1500
2021-03-04,Florida Panthers,5,Nashville Predators,4,1,0,0,1500,1500
2021-03-04,Buffalo Sabres,2,New York Islanders,5,3,0,0,1500,1500
2021-03-04,Philadelphia Flyers,4,Pittsburgh Penguins,3,1,0,0,1500,1500
2021-03-04,Toronto Maple Leafs,1,Vancouver Canucks,3,2,1,0,1500,1500
2021-03-05,Minnesota Wild,5,Arizona Coyotes,1,4,0,0,1500,1500
2021-03-05,Washington Capitals,1,Boston Bruins,5,4,0,0,1500,1500
2021-03-05,Tampa Bay Lightning,3,Chicago Blackhawks,4,1,1,1,1500,1500
2021-03-05,Anaheim Ducks,2,Colorado Avalanche,3,1,0,0,1500,1500
2021-03-05,St. Louis Blues,3,Los Angeles Kings,2,1,0,0,1500,1500
2021-03-05,Vegas Golden Knights,5,San Jose Sharks,4,1,0,0,1500,1500
2021-03-06,Minnesota Wild,2,Arizona Coyotes,5,3,1,1,1500,1500
2021-03-06,Anaheim Ducks,5,Colorado Avalanche,4,1,1,1,1500,1500
2021-03-06,Columbus Blue Jackets,0,Dallas Stars,5,5,0,0,1500,1500
2021-03-06,Calgary Flames,2,Edmonton Oilers,3,1,0,0,1500,1500
2021-03-06,St. Louis Blues,3,Los Angeles Kings,4,1,1,1,1500,1500
2021-03-06,Winnipeg Jets,1,Montreal Canadiens,7,6,0,0,1500,1500
2021-03-06,New York Rangers,6,New Jersey Devils,3,3,0,0,1500,1500
2021-03-06,Florida Panthers,6,Nashville Predators,2,4,0,0,1500,1500
2021-03-06,Buffalo Sabres,2,New York Islanders,5,3,0,0,1500,1500
2021-03-06,Philadelphia Flyers,3,Pittsburgh Penguins,4,1,0,0,1500,1500
2021-03-06,Vegas Golden Knights,4,San Jose Sharks,0,4,1,1,1500,1500
2021-03-06,Toronto Maple Leafs,2,Vancouver Canucks,4,2,0,0,1500,1500
2021-03-07,New Jersey Devils,1,Boston Bruins,0,1,1,0,1500,1500
2021-03-07,Florida Panthers,2,Carolina Hurricanes,4,2,1,0,1500,1500
2021-03-07,Ottawa Senators,4,Calgary Flames,3,1,0,1,1500,1500
2021-03-07,Tampa Bay Lightning,6,Chicago Blackhawks,3,3,0,0,1500,1500
2021-03-07,Nashville Predators,4,Dallas Stars,3,1,1,1,1500,1500
2021-03-07,Buffalo Sabres,2,New York Islanders,5,3,1,1,1500,1500
2021-03-07,Washington Capitals,3,Philadelphia Flyers,1,2,0,1,1500,1500
2021-03-07,New York Rangers,1,Pittsburgh Penguins,5,4,1,1,1500,1500
2021-03-08,Los Angeles Kings,5,Anaheim Ducks,6,1,0,0,1500,1500
2021-03-08,Arizona Coyotes,3,Colorado Avalanche,2,1,0,0,1500,1500
2021-03-08,Ottawa Senators,2,Edmonton Oilers,3,1,1,0,1500,1500
2021-03-08,Vegas Golden Knights,0,Minnesota Wild,2,2,0,0,1500,1500
2021-03-08,St. Louis Blues,2,San Jose Sharks,3,1,0,0,1500,1500
2021-03-08,Montreal Canadiens,1,Vancouver Canucks,2,1,0,0,1500,1500
2021-03-09,Nashville Predators,2,Carolina Hurricanes,3,1,0,0,1500,1500
2021-03-09,Florida Panthers,4,Columbus Blue Jackets,2,2,0,0,1500,1500
2021-03-09,Chicago Blackhawks,1,Dallas Stars,6,5,0,0,1500,1500
2021-03-09,Tampa Bay Lightning,4,Detroit Red Wings,3,1,0,0,1500,1500
2021-03-09,Boston Bruins,1,New York Islanders,2,1,0,0,1500,1500
2021-03-09,Buffalo Sabres,4,Philadelphia Flyers,5,1,0,0,1500,1500
2021-03-09,New York Rangers,2,Pittsburgh Penguins,4,2,0,0,1500,1500
2021-03-09,Winnipeg Jets,4,Toronto Maple Leafs,3,1,0,0,1500,1500
2021-03-09,New Jersey Devils,4,Washington Capitals,5,1,0,0,1500,1500
2021-03-10,Los Angeles Kings,5,Anaheim Ducks,1,4,0,0,1500,1500
2021-03-10,Arizona Coyotes,1,Colorado Avalanche,2,1,0,0,1500,1500
2021-03-10,Ottawa Senators,1,Edmonton Oilers,7,6,0,0,1500,1500
2021-03-10,Vegas Golden Knights,3,Minnesota Wild,4,1,0,0,1500,1500
2021-03-10,Montreal Canadiens,5,Vancouver Canucks,1,4,0,0,1500,1500
2021-03-11,New York Rangers,0,Boston Bruins,4,4,0,0,1500,1500
2021-03-11,Pittsburgh Penguins,5,Buffalo Sabres,2,3,0,0,1500,1500
2021-03-11,Nashville Predators,1,Carolina Hurricanes,5,4,0,0,1500,1500
2021-03-11,Florida Panthers,5,Columbus Blue Jackets,4,1,0,0,1500,1500
2021-03-11,Montreal Canadiens,1,Calgary Flames,2,1,1,0,1500,1500
2021-03-11,Chicago Blackhawks,4,Dallas Stars,2,2,0,0,1500,1500
2021-03-11,Tampa Bay Lightning,4,Detroit Red Wings,6,2,0,0,1500,1500
2021-03-11,New Jersey Devils,3,New York Islanders,5,2,0,0,1500,1500
2021-03-11,Washington Capitals,5,Philadelphia Flyers,3,2,0,0,1500,1500
2021-03-11,Winnipeg Jets,3,Toronto Maple Leafs,4,1,0,0,1500,1500
2021-03-12,San Jose Sharks,6,Anaheim Ducks,0,6,0,0,1500,1500
2021-03-12,Los Angeles Kings,0,Colorado Avalanche,2,2,0,0,1500,1500
2021-03-12,Ottawa Senators,2,Edmonton Oilers,6,4,0,0,1500,1500
2021-03-12,Arizona Coyotes,0,Minnesota Wild,4,4,0,0,1500,1500
2021-03-12,Vegas Golden Knights,5,St. Louis Blues,4,1,0,0,1500,1500
2021-03-13,San Jose Sharks,3,Anaheim Ducks,1,2,1,1,1500,1500
2021-03-13,New York Rangers,4,Boston Bruins,0,4,0,0,1500,1500
2021-03-13,Pittsburgh Penguins,3,Buffalo Sabres,0,3,0,0,1500,1500
2021-03-13,Dallas Stars,3,Columbus Blue Jackets,4,1,0,0,1500,1500
2021-03-13,Montreal Canadiens,1,Calgary Flames,3,2,0,0,1500,1500
2021-03-13,Chicago Blackhawks,2,Florida Panthers,4,2,0,0,1500,1500
2021-03-13,New York Islanders,3,New Jersey Devils,2,1,0,0,1500,1500
2021-03-13,Washington Capitals,5,Philadelphia Flyers,4,1,0,0,1500,1500
2021-03-13,Vegas Golden Knights,5,St. Louis Blues,1,4,1,1,1500,1500
2021-03-13,Nashville Predators,3,Tampa Bay Lightning,6,3,0,0,1500,1500
2021-03-13,Winnipeg Jets,5,Toronto Maple Leafs,2,3,0,0,1500,1500
2021-03-13,Edmonton Oilers,1,Vancouver Canucks,2,1,1,0,1500,1500
2021-03-14,Dallas Stars,2,Columbus Blue Jackets,1,1,1,1,1500,1500
2021-03-14,Los Angeles Kings,1,Colorado Avalanche,4,3,0,0,1500,1500
2021-03-14,Carolina Hurricanes,2,Detroit Red Wings,1,1,0,0,1500,1500
2021-03-14,Arizona Coyotes,1,Minnesota Wild,4,3,0,0,1500,1500
2021-03-14,New York Islanders,3,New Jersey Devils,2,1,1,1,1500,1500
2021-03-14,Toronto Maple Leafs,3,Ottawa Senators,4,1,1,0,1500,1500
2021-03-15,Washington Capitals,6,Buffalo Sabres,0,6,0,0,1500,1500
2021-03-15,Edmonton Oilers,3,Calgary Flames,4,1,0,0,1500,1500
2021-03-15,Chicago Blackhawks,3,Florida Panthers,6,3,0,0,1500,1500
2021-03-15,Philadelphia Flyers,5,New York Rangers,4,1,0,0,1500,1500
2021-03-15,Vancouver Canucks,3,Ottawa Senators,2,1,0,1,1500,1500
2021-03-15,Boston Bruins,1,Pittsburgh Penguins,4,3,0,0,1500,1500
2021-03-15,Nashville Predators,4,Tampa Bay Lightning,1,3,0,0,1500,1500
2021-03-15,San Jose Sharks,1,Vegas Golden Knights,2,1,0,0,1500,1500
2021-03-15,Montreal Canadiens,4,Winnipeg Jets,2,2,0,0,1500,1500
2021-03-16,Anaheim Ducks,4,Colorado Avalanche,8,4,0,0,1500,1500
2021-03-16,Tampa Bay Lightning,4,Dallas Stars,3,1,1,0,1500,1500
2021-03-16,Carolina Hurricanes,2,Detroit Red Wings,4,2,0,0,1500,1500
2021-03-16,Arizona Coyotes,0,Minnesota Wild,3,3,0,0,1500,1500
2021-03-16,Buffalo Sabres,2,New Jersey Devils,3,1,1,0,1500,1500
2021-03-16,Boston Bruins,2,Pittsburgh Penguins,1,1,1,1,1500,1500
2021-03-16,New York Islanders,1,Washington Capitals,3,2,0,1,1500,1500
2021-03-17,Edmonton Oilers,7,Calgary Flames,3,4,0,0,1500,1500
2021-03-17,St. Louis Blues,1,Los Angeles Kings,4,3,0,0,1500,1500
2021-03-17,Philadelphia Flyers,0,New York Rangers,9,9,0,0,1500,1500
2021-03-17,Vancouver Canucks,3,Ottawa Senators,2,1,0,0,1500,1500
2021-03-17,San Jose Sharks,4,Vegas Golden Knights,5,1,0,0,1500,1500
2021-03-17,Montreal Canadiens,3,Winnipeg Jets,4,1,0,0,1500,1500
2021-03-18,Arizona Coyotes,2,Anaheim Ducks,3,1,0,0,1500,1500
2021-03-18,Boston Bruins,4,Buffalo Sabres,1,3,0,0,1500,1500
2021-03-18,Columbus Blue Jackets,3,Carolina Hurricanes,2,1,0,0,1500,1500
2021-03-18,Minnesota Wild,1,Colorado Avalanche,5,4,0,0,1500,1500
2021-03-18,Dallas Stars,2,Detroit Red Wings,3,1,0,0,1500,1500
2021-03-18,Winnipeg Jets,1,Edmonton Oilers,2,1,1,1,1500,1500
2021-03-18,Nashville Predators,2,Florida Panthers,1,1,0,0,1500,1500
2021-03-18,Pittsburgh Penguins,2,New Jersey Devils,3,1,0,0,1500,1500
2021-03-18,Philadelphia Flyers,4,New York Islanders,3,1,1,0,1500,1500
2021-03-18,Chicago Blackhawks,2,Tampa Bay Lightning,4,2,0,0,1500,1500
2021-03-19,Vegas Golden Knights,4,Los Angeles Kings,2,2,0,0,1500,1500
2021-03-19,Vancouver Canucks,3,Montreal Canadiens,2,1,0,0,1500,1500
2021-03-19,St. Louis Blues,2,San Jose Sharks,1,1,0,0,1500,1500
2021-03-19,Calgary Flames,4,Toronto Maple Leafs,3,1,0,0,1500,1500
2021-03-19,New York Rangers,1,Washington Capitals,2,1,0,0,1500,1500
2021-03-20,Arizona Coyotes,5,Anaheim Ducks,1,4,0,0,1500,1500
2021-03-20,Columbus Blue Jackets,3,Carolina Hurricanes,2,1,0,0,1500,1500
2021-03-20,Minnesota Wild,0,Colorado Avalanche,6,6,0,0,1500,1500
2021-03-20,Dallas Stars,3,Detroit Red Wings,0,3,0,0,1500,1500
2021-03-20,Winnipeg Jets,2,Edmonton Oilers,4,2,0,0,1500,1500
2021-03-20,Nashville Predators,0,Florida Panthers,2,2,0,0,1500,1500
2021-03-20,Vancouver Canucks,4,Montreal Canadiens,5,1,1,1,1500,1500
2021-03-20,Pittsburgh Penguins,3,New Jersey Devils,1,2,0,0,1500,1500
2021-03-20,Philadelphia Flyers,1,New York Islanders,6,5,0,0,1500,1500
2021-03-20,St. Louis Blues,5,San Jose Sharks,2,3,1,1,1500,1500
2021-03-20,Chicago Blackhawks,1,Tampa Bay Lightning,4,3,0,0,1500,1500
2021-03-20,Calgary Flames,0,Toronto Maple Leafs,2,2,1,1,1500,1500
2021-03-20,New York Rangers,3,Washington Capitals,1,2,1,1,1500,1500
2021-03-21,Nashville Predators,4,Dallas Stars,3,1,1,1,1500,1500
2021-03-21,Vegas Golden Knights,1,Los Angeles Kings,3,2,0,0,1500,1500
2021-03-21,New Jersey Devils,2,Pittsburgh Penguins,1,1,1,1,1500,1500
2021-03-21,Florida Panthers,3,Tampa Bay Lightning,5,2,1,1,1500,1500
2021-03-22,Colorado Avalanche,5,Arizona Coyotes,1,4,0,0,1500,1500
2021-03-22,Carolina Hurricanes,3,Columbus Blue Jackets,0,3,0,0,1500,1500
2021-03-22,Anaheim Ducks,1,Minnesota Wild,2,1,0,0,1500,1500
2021-03-22,Buffalo Sabres,3,New York Rangers,5,2,0,0,1500,1500
2021-03-22,Calgary Flames,1,Ottawa Senators,2,1,0,0,1500,1500
2021-03-22,New York Islanders,2,Philadelphia Flyers,1,1,0,0,1500,1500
2021-03-22,Los Angeles Kings,1,San Jose Sharks,2,1,1,0,1500,1500
2021-03-22,Winnipeg Jets,4,Vancouver Canucks,0,4,0,0,1500,1500
2021-03-22,St. Louis Blues,1,Vegas Golden Knights,5,4,0,1,1500,1500
2021-03-23,Colorado Avalanche,4,Arizona Coyotes,5,1,1,1,1500,1500
2021-03-23,Florida Panthers,2,Chicago Blackhawks,3,1,0,0,1500,1500
2021-03-23,Tampa Bay Lightning,2,Dallas Stars,1,1,0,0,1500,1500
2021-03-23,Detroit Red Wings,0,Nashville Predators,2,2,0,0,1500,1500
2021-03-23,New Jersey Devils,4,Philadelphia Flyers,3,1,0,1,1500,1500
2021-03-24,Anaheim Ducks,2,Minnesota Wild,3,1,0,0,1500,1500
2021-03-24,Calgary Flames,1,Ottawa Senators,3,2,0,0,1500,1500
2021-03-24,Buffalo Sabres,2,Pittsburgh Penguins,5,3,0,0,1500,1500
2021-03-24,Los Angeles Kings,2,San Jose Sharks,4,2,0,0,1500,1500
2021-03-24,Winnipeg Jets,5,Vancouver Canucks,1,4,0,0,1500,1500
2021-03-25,New York Islanders,4,Boston Bruins,3,1,0,0,1500,1500
2021-03-25,Carolina Hurricanes,4,Columbus Blue Jackets,3,1,0,0,1500,1500
2021-03-25,Florida Panthers,0,Chicago Blackhawks,3,3,0,0,1500,1500
2021-03-25,Vegas Golden Knights,1,Colorado Avalanche,5,4,0,0,1500,1500
2021-03-25,Tampa Bay Lightning,3,Dallas Stars,4,1,0,0,1500,1500
2021-03-25,St. Louis Blues,0,Minnesota Wild,2,2,0,1,1500,1500
2021-03-25,Detroit Red Wings,1,Nashville Predators,7,6,0,0,1500,1500
2021-03-25,Toronto Maple Leafs,3,Ottawa Senators,2,1,0,1,1500,1500
2021-03-25,New York Rangers,8,Philadelphia Flyers,3,5,0,0,1500,1500
2021-03-25,Buffalo Sabres,0,Pittsburgh Penguins,4,4,1,1,1500,1500
2021-03-25,New Jersey Devils,3,Washington Capitals,4,1,0,0,1500,1500
2021-03-26,San Jose Sharks,2,Arizona Coyotes,5,3,0,0,1500,1500
2021-03-26,Winnipeg Jets,3,Calgary Flames,2,1,0,0,1500,1500
2021-03-26,Anaheim Ducks,4,St. Louis Blues,1,3,0,1,1500,1500
2021-03-26,New Jersey Devils,0,Washington Capitals,4,4,1,1,1500,1500
2021-03-27,San Jose Sharks,0,Arizona Coyotes,4,4,1,1,1500,1500
2021-03-27,Buffalo Sabres,2,Boston Bruins,3,1,0,0,1500,1500
2021-03-27,Tampa Bay Lightning,3,Carolina Hurricanes,4,1,0,0,1500,1500
2021-03-27,Winnipeg Jets,2,Calgary Flames,4,2,1,1,1500,1500
2021-03-27,Nashville Predators,3,Chicago Blackhawks,1,2,0,0,1500,1500
2021-03-27,Vegas Golden Knights,3,Colorado Avalanche,2,1,0,0,1500,1500
2021-03-27,Florida Panthers,4,Dallas Stars,3,1,0,0,1500,1500
2021-03-27,Columbus Blue Jackets,1,Detroit Red Wings,3,2,0,0,1500,1500
2021-03-27,New York Rangers,1,Philadelphia Flyers,2,1,0,0,1500,1500
2021-03-27,New York Islanders,3,Pittsburgh Penguins,6,3,0,0,1500,1500
2021-03-27,Edmonton Oilers,3,Toronto Maple Leafs,4,1,0,0,1500,1500
2021-03-28,New Jersey Devils,1,Boston Bruins,0,1,0,1,1500,1500
2021-03-28,Nashville Predators,3,Chicago Blackhawks,2,1,1,1,1500,1500
2021-03-28,Florida Panthers,4,Dallas Stars,1,3,1,1,1500,1500
2021-03-28,Columbus Blue Jackets,1,Detroit Red Wings,4,3,1,1,1500,1500
2021-03-28,Anaheim Ducks,3,St. Louis Blues,2,1,0,0,1500,1500
2021-03-28,New York Rangers,4,Washington Capitals,5,1,1,0,1500,1500
2021-03-29,Philadelphia Flyers,4,Buffalo Sabres,3,1,0,0,1500,1500
2021-03-29,Winnipeg Jets,5,Calgary Flames,1,4,0,0,1500,1500
2021-03-29,Anaheim Ducks,2,Colorado Avalanche,5,3,1,0,1500,1500
2021-03-29,New York Islanders,1,Pittsburgh Penguins,2,1,0,0,1500,1500
2021-03-29,Minnesota Wild,3,San Jose Sharks,4,1,0,0,1500,1500
2021-03-29,Edmonton Oilers,3,Toronto Maple Leafs,2,1,0,0,1500,1500
2021-03-29,Los Angeles Kings,1,Vegas Golden Knights,4,3,0,0,1500,1500
2021-03-30,New Jersey Devils,4,Boston Bruins,5,1,0,0,1500,1500
2021-03-30,Carolina Hurricanes,1,Chicago Blackhawks,2,1,0,0,1500,1500
2021-03-30,Detroit Red Wings,1,Florida Panthers,4,3,0,0,1500,1500
2021-03-30,Edmonton Oilers,0,Montreal Canadiens,4,4,1,0,1500,1500
2021-03-30,Dallas Stars,2,Nashville Predators,3,1,0,0,1500,1500
2021-03-30,Washington Capitals,2,New York Rangers,5,3,0,0,1500,1500
2021-03-30,Columbus Blue Jackets,3,Tampa Bay Lightning,1,2,0,0,1500,1500
2021-03-31,Philadelphia Flyers,1,Buffalo Sabres,6,5,0,0,1500,1500
2021-03-31,Arizona Coyotes,3,Colorado Avalanche,9,6,0,0,1500,1500
2021-03-31,Minnesota Wild,2,San Jose Sharks,4,2,0,0,1500,1500
2021-03-31,Los Angeles Kings,4,Vegas Golden Knights,2,2,0,0,1500,1500
2021-03-31,Toronto Maple Leafs,3,Winnipeg Jets,1,2,0,0,1500,1500
2021-04-01,Pittsburgh Penguins,4,Boston Bruins,1,3,0,0,1500,1500
2021-04-01,New York Rangers,3,Buffalo Sabres,2,1,0,1,1500,1500
2021-04-01,Carolina Hurricanes,4,Chicago Blackhawks,3,1,0,0,1500,1500
2021-04-01,Detroit Red Wings,2,Florida Panthers,3,1,0,0,1500,1500
2021-04-01,Dallas Stars,4,Nashville Predators,1,3,0,0,1500,1500
2021-04-01,Washington Capitals,4,New York Islanders,8,4,0,0,1500,1500
2021-04-01,Montreal Canadiens,4,Ottawa Senators,1,3,0,0,1500,1500
2021-04-01,Columbus Blue Jackets,2,Tampa Bay Lightning,3,1,0,0,1500,1500
2021-04-01,Minnesota Wild,3,Vegas Golden Knights,2,1,1,1,1500,1500
2021-04-02,Arizona Coyotes,4,Anaheim Ducks,2,2,0,0,1500,1500
2021-04-02,St. Louis Blues,2,Colorado Avalanche,3,1,0,0,1500,1500
2021-04-02,Calgary Flames,2,Edmonton Oilers,3,1,0,0,1500,1500
2021-04-02,San Jose Sharks,3,Los Angeles Kings,0,3,0,0,1500,1500
2021-04-02,Washington Capitals,2,New Jersey Devils,1,1,1,0,1500,1500
2021-04-02,Toronto Maple Leafs,2,Winnipeg Jets,1,1,0,0,1500,1500
2021-04-03,Pittsburgh Penguins,5,Boston Bruins,7,2,0,0,1500,1500
2021-04-03,New York Rangers,2,Buffalo Sabres,3,1,0,0,1500,1500
2021-04-03,Dallas Stars,3,Carolina Hurricanes,2,1,0,0,1500,1500
2021-04-03,St. Louis Blues,1,Colorado Avalanche,2,1,1,1,1500,1500
2021-04-03,Columbus Blue Jackets,2,Florida Panthers,5,3,0,0,1500,1500
2021-04-03,San Jose Sharks,3,Los Angeles Kings,2,1,1,1,1500,1500
2021-04-03,Ottawa Senators,6,Montreal Canadiens,3,3,0,0,1500,1500
2021-04-03,Chicago Blackhawks,0,Nashville Predators,3,3,0,0,1500,1500
2021-04-03,Philadelphia Flyers,2,New York Islanders,3,1,0,0,1500,1500
2021-04-03,Detroit Red Wings,1,Tampa Bay Lightning,2,1,0,0,1500,1500
2021-04-03,Minnesota Wild,2,Vegas Golden Knights,1,1,0,0,1500,1500
2021-04-04,Arizona Coyotes,3,Anaheim Ducks,2,1,0,0,1500,1500
2021-04-04,Dallas Stars,0,Carolina Hurricanes,1,1,1,1,1500,1500
2021-04-04,Toronto Maple Leafs,4,Calgary Flames,2,2,0,0,1500,1500
2021-04-04,Columbus Blue Jackets,0,Florida Panthers,3,3,1,1,1500,1500
2021-04-04,Washington Capitals,5,New Jersey Devils,4,1,0,0,1500,1500
2021-04-04,Detroit Red Wings,5,Tampa Bay Lightning,1,4,1,1,1500,1500
2021-04-05,Philadelphia Flyers,3,Boston Bruins,2,1,0,0,1500,1500
2021-04-05,Toronto Maple Leafs,5,Calgary Flames,3,2,1,1,1500,1500
2021-04-05,Arizona Coyotes,5,Los Angeles Kings,2,3,1,0,1500,1500
2021-04-05,Colorado Avalanche,5,Minnesota Wild,4,1,0,0,1500,1500
2021-04-05,Edmonton Oilers,2,Montreal Canadiens,3,1,0,0,1500,1500
2021-04-05,Vegas Golden Knights,6,St. Louis Blues,1,5,0,0,1500,1500
2021-04-05,Ottawa Senators,3,Winnipeg Jets,4,1,0,0,1500,1500
2021-04-06,Florida Panthers,2,Carolina Hurricanes,5,3,0,0,1500,1500
2021-04-06,Tampa Bay Lightning,2,Columbus Blue Jackets,4,2,0,0,1500,1500
2021-04-06,Dallas Stars,2,Chicago Blackhawks,4,2,0,0,1500,1500
2021-04-06,Nashville Predators,3,Detroit Red Wings,2,1,0,0,1500,1500
2021-04-06,Buffalo Sabres,5,New Jersey Devils,3,2,0,0,1500,1500
2021-04-06,Washington Capitals,0,New York Islanders,1,1,0,0,1500,1500
2021-04-06,Pittsburgh Penguins,4,New York Rangers,8,4,0,0,1500,1500
2021-04-06,Boston Bruins,4,Philadelphia Flyers,2,2,1,1,1500,1500
2021-04-06,Anaheim Ducks,5,San Jose Sharks,1,4,0,0,1500,1500
2021-04-07,Arizona Coyotes,3,Los Angeles Kings,4,1,0,0,1500,1500
2021-04-07,Colorado Avalanche,3,Minnesota Wild,8,5,0,0,1500,1500
2021-04-07,Edmonton Oilers,4,Ottawa Senators,2,2,0,0,1500,1500
2021-04-07,Vegas Golden Knights,1,St. Louis Blues,3,2,0,0,1500,1500
2021-04-07,Montreal Canadiens,2,Toronto Maple Leafs,3,1,0,0,1500,1500
2021-04-08,New Jersey Devils,6,Buffalo Sabres,3,3,0,0,1500,1500
2021-04-08,Florida Panthers,0,Carolina Hurricanes,3,3,0,0,1500,1500
2021-04-08,Tampa Bay Lightning,6,Columbus Blue Jackets,4,2,0,0,1500,1500
2021-04-08,Dallas Stars,5,Chicago Blackhawks,1,4,0,0,1500,1500
2021-04-08,Nashville Predators,7,Detroit Red Wings,1,6,0,0,1500,1500
2021-04-08,Winnipeg Jets,4,Montreal Canadiens,2,2,0,1,1500,1500
2021-04-08,Philadelphia Flyers,2,New York Islanders,3,1,0,0,1500,1500
2021-04-08,Pittsburgh Penguins,5,New York Rangers,2,3,0,0,1500,1500
2021-04-08,Edmonton Oilers,3,Ottawa Senators,1,2,1,1,1500,1500
2021-04-08,Boston Bruins,4,Washington Capitals,2,2,0,0,1500,1500
2021-04-09,Colorado Avalanche,2,Anaheim Ducks,0,2,0,0,1500,1500
2021-04-09,Washington Capitals,4,Buffalo Sabres,3,1,1,1,1500,1500
2021-04-09,Pittsburgh Penguins,6,New Jersey Devils,4,2,1,1,1500,1500
2021-04-09,New York Rangers,4,New York Islanders,1,3,1,1,1500,1500
2021-04-09,Los Angeles Kings,2,San Jose Sharks,5,3,0,0,1500,1500
2021-04-09,Minnesota Wild,1,St. Louis Blues,9,8,0,0,1500,1500
2021-04-09,Arizona Coyotes,4,Vegas Golden Knights,7,3,0,0,1500,1500
2021-04-10,Detroit Red Wings,5,Carolina Hurricanes,4,1,0,0,1500,1500
2021-04-10,Chicago Blackhawks,4,Columbus Blue Jackets,3,1,0,0,1500,1500
2021-04-10,Edmonton Oilers,0,Calgary Flames,5,5,0,0,1500,1500
2021-04-10,Florida Panthers,1,Dallas Stars,4,3,0,0,1500,1500
2021-04-10,Winnipeg Jets,5,Montreal Canadiens,0,5,0,0,1500,1500
2021-04-10,Tampa Bay Lightning,3,Nashville Predators,0,3,0,0,1500,1500
2021-04-10,Boston Bruins,2,Philadelphia Flyers,3,1,0,0,1500,1500
2021-04-10,Los Angeles Kings,4,San Jose Sharks,2,2,1,1,1500,1500
2021-04-10,Minnesota Wild,2,St. Louis Blues,3,1,1,1,1500,1500
2021-04-10,Ottawa Senators,5,Toronto Maple Leafs,6,1,0,0,1500,1500
2021-04-11,Colorado Avalanche,4,Anaheim Ducks,1,3,0,0,1500,1500
2021-04-11,Washington Capitals,8,Boston Bruins,1,7,0,1,1500,1500
2021-04-11,Pittsburgh Penguins,5,New Jersey Devils,2,3,0,0,1500,1500
2021-04-11,Dallas Stars,2,Nashville Predators,3,1,1,1,1500,1500
2021-04-11,New York Rangers,2,New York Islanders,3,1,0,0,1500,1500
2021-04-11,Buffalo Sabres,5,Philadelphia Flyers,3,2,0,1,1500,1500
2021-04-11,Arizona Coyotes,0,Vegas Golden Knights,1,1,0,0,1500,1500
2021-04-12,Detroit Red Wings,3,Carolina Hurricanes,1,2,0,0,1500,1500
2021-04-12,Chicago Blackhawks,4,Columbus Blue Jackets,3,1,0,0,1500,1500
2021-04-12,Arizona Coyotes,2,Colorado Avalanche,4,2,1,1,1500,1500
2021-04-12,Vegas Golden Knights,4,Los Angeles Kings,2,2,1,0,1500,1500
2021-04-12,Toronto Maple Leafs,2,Montreal Canadiens,4,2,0,0,1500,1500
2021-04-12,Winnipeg Jets,2,Ottawa Senators,4,2,0,0,1500,1500
2021-04-12,Anaheim Ducks,4,San Jose Sharks,0,4,1,0,1500,1500
2021-04-13,Buffalo Sabres,2,Boston Bruins,3,1,0,0,1500,1500
2021-04-13,Florida Panthers,3,Dallas Stars,2,1,0,0,1500,1500
2021-04-13,New York Rangers,3,New Jersey Devils,0,3,0,0,1500,1500
2021-04-13,Tampa Bay Lightning,2,Nashville Predators,7,5,0,0,1500,1500
2021-04-13,Calgary Flames,3,Toronto Maple Leafs,2,1,0,1,1500,1500
2021-04-13,Philadelphia Flyers,1,Washington Capitals,6,5,0,0,1500,1500
2021-04-14,Vegas Golden Knights,6,Los Angeles Kings,2,4,0,0,1500,1500
2021-04-14,Arizona Coyotes,2,Minnesota Wild,5,3,0,0,1500,1500
2021-04-14,Calgary Flames,4,Montreal Canadiens,1,3,1,0,1500,1500
2021-04-14,Winnipeg Jets,3,Ottawa Senators,2,1,0,0,1500,1500
2021-04-14,Anaheim Ducks,4,San Jose Sharks,1,3,0,0,1500,1500
2021-04-14,Colorado Avalanche,4,St. Louis Blues,3,1,0,0,1500,1500
2021-04-15,New York Islanders,1,Boston Bruins,4,3,0,0,1500,1500
2021-04-15,Nashville Predators,1,Carolina Hurricanes,4,3,0,0,1500,1500
2021-04-15,Columbus Blue Jackets,1,Dallas Stars,4,3,0,0,1500,1500
2021-04-15,Chicago Blackhawks,1,Detroit Red Wings,4,3,0,0,1500,1500
2021-04-15,New Jersey Devils,0,New York Rangers,4,4,0,0,1500,1500
2021-04-15,Philadelphia Flyers,2,Pittsburgh Penguins,1,1,0,0,1500,1500
2021-04-15,Florida Panthers,2,Tampa Bay Lightning,3,1,0,0,1500,1500
2021-04-15,Winnipeg Jets,5,Toronto Maple Leafs,2,3,1,0,1500,1500
2021-04-15,Buffalo Sabres,5,Washington Capitals,2,3,0,0,1500,1500
2021-04-16,Vegas Golden Knights,4,Anaheim Ducks,0,4,0,0,1500,1500
2021-04-16,New York Islanders,0,Boston Bruins,3,3,1,1,1500,1500
2021-04-16,San Jose Sharks,2,Minnesota Wild,3,1,0,0,1500,1500
2021-04-16,Calgary Flames,1,Montreal Canadiens,2,1,0,0,1500,1500
2021-04-17,St. Louis Blues,2,Arizona Coyotes,3,1,0,0,1500,1500
2021-04-17,Pittsburgh Penguins,3,Buffalo Sabres,2,1,0,0,1500,1500
2021-04-17,Nashville Predators,1,Carolina Hurricanes,3,2,0,0,1500,1500
2021-04-17,Columbus Blue Jackets,1,Dallas Stars,5,4,0,0,1500,1500
2021-04-17,Chicago Blackhawks,4,Detroit Red Wings,0,4,0,0,1500,1500
2021-04-17,San Jose Sharks,2,Minnesota Wild,5,3,1,1,1500,1500
2021-04-17,Ottawa Senators,4,Montreal Canadiens,0,4,0,1,1500,1500
2021-04-17,New Jersey Devils,3,New York Rangers,6,3,0,0,1500,1500
2021-04-17,Washington Capitals,6,Philadelphia Flyers,3,3,0,0,1500,1500
2021-04-17,Florida Panthers,5,Tampa Bay Lightning,3,2,0,0,1500,1500
2021-04-17,Edmonton Oilers,3,Winnipeg Jets,0,3,0,0,1500,1500
2021-04-18,Vegas Golden Knights,5,Anaheim Ducks,2,3,0,0,1500,1500
2021-04-18,Washington Capitals,3,Boston Bruins,6,3,1,0,1500,1500
2021-04-18,Pittsburgh Penguins,2,Buffalo Sabres,4,2,1,1,1500,1500
2021-04-18,New York Rangers,5,New Jersey Devils,3,2,1,1,1500,1500
2021-04-18,New York Islanders,1,Philadelphia Flyers,0,1,0,1,1500,1500
2021-04-18,Toronto Maple Leafs,2,Vancouver Canucks,3,1,0,0,1500,1500
2021-04-19,Minnesota Wild,5,Arizona Coyotes,2,3,0,0,1500,1500
2021-04-19,Ottawa Senators,4,Calgary Flames,2,2,0,0,1500,1500
2021-04-19,Detroit Red Wings,2,Dallas Stars,3,1,0,0,1500,1500
2021-04-19,Montreal Canadiens,1,Edmonton Oilers,4,3,0,0,1500,1500
2021-04-19,Columbus Blue Jackets,2,Florida Panthers,4,2,0,0,1500,1500
2021-04-19,Chicago Blackhawks,2,Nashville Predators,5,3,0,0,1500,1500
2021-04-19,Carolina Hurricanes,2,Tampa Bay Lightning,3,1,0,0,1500,1500
2021-04-19,San Jose Sharks,2,Vegas Golden Knights,3,1,0,1,1500,1500
2021-04-20,Boston Bruins,2,Buffalo Sabres,0,2,0,0,1500,1500
2021-04-20,Detroit Red Wings,2,Dallas Stars,5,3,1,1,1500,1500
2021-04-20,Columbus Blue Jackets,1,Florida Panthers,5,4,1,1,1500,1500
2021-04-20,Anaheim Ducks,1,Los Angeles Kings,4,3,0,0,1500,1500
2021-04-20,New York Rangers,1,New York Islanders,6,5,0,0,1500,1500
2021-04-20,New Jersey Devils,6,Pittsburgh Penguins,7,1,0,0,1500,1500
2021-04-20,Carolina Hurricanes,4,Tampa Bay Lightning,1,3,1,1,1500,1500
2021-04-20,Toronto Maple Leafs,3,Vancouver Canucks,6,3,0,0,1500,1500
2021-04-21,Minnesota Wild,4,Arizona Coyotes,1,3,0,0,1500,1500
2021-04-21,Nashville Predators,4,Chicago Blackhawks,5,1,0,0,1500,1500
2021-04-21,Montreal Canadiens,4,Edmonton Oilers,3,1,0,0,1500,1500
2021-04-21,San Jose Sharks,2,Vegas Golden Knights,5,3,0,0,1500,1500
2021-04-22,Boston Bruins,5,Buffalo Sabres,1,4,0,0,1500,1500
2021-04-22,Dallas Stars,3,Detroit Red Wings,7,4,0,0,1500,1500
2021-04-22,Carolina Hurricanes,4,Florida Panthers,2,2,0,0,1500,1500
2021-04-22,Washington Capitals,1,New York Islanders,0,1,0,0,1500,1500
2021-04-22,Philadelphia Flyers,3,New York Rangers,2,1,0,0,1500,1500
2021-04-22,New Jersey Devils,1,Pittsburgh Penguins,5,4,0,0,1500,1500
2021-04-22,Colorado Avalanche,4,St. Louis Blues,2,2,0,0,1500,1500
2021-04-22,Columbus Blue Jackets,1,Tampa Bay Lightning,3,2,0,0,1500,1500
2021-04-22,Ottawa Senators,3,Vancouver Canucks,0,3,0,0,1500,1500
2021-04-22,Toronto Maple Leafs,5,Winnipeg Jets,3,2,0,0,1500,1500
2021-04-23,Boston Bruins,4,Buffalo Sabres,6,2,1,1,1500,1500
2021-04-23,Montreal Canadiens,2,Calgary Flames,4,2,0,0,1500,1500
2021-04-23,Nashville Predators,3,Chicago Blackhawks,1,2,0,0,1500,1500
2021-04-23,Minnesota Wild,4,Los Angeles Kings,2,2,0,0,1500,1500
2021-04-23,Philadelphia Flyers,1,New York Rangers,4,3,1,1,1500,1500
2021-04-24,Vegas Golden Knights,5,Anaheim Ducks,1,4,0,0,1500,1500
2021-04-24,Montreal Canadiens,2,Calgary Flames,5,3,1,1,1500,1500
2021-04-24,Dallas Stars,2,Detroit Red Wings,1,1,0,0,1500,1500
2021-04-24,Carolina Hurricanes,3,Florida Panthers,4,1,0,0,1500,1500
2021-04-24,Arizona Coyotes,4,Los Angeles Kings,0,4,0,1,1500,1500
2021-04-24,Washington Capitals,6,New York Islanders,3,3,0,0,1500,1500
2021-04-24,New Jersey Devils,2,Pittsburgh Penguins,4,2,0,0,1500,1500
2021-04-24,Minnesota Wild,6,San Jose Sharks,3,3,1,0,1500,1500
2021-04-24,Colorado Avalanche,3,St. Louis Blues,5,2,0,0,1500,1500
2021-04-24,Ottawa Senators,2,Vancouver Canucks,4,2,0,0,1500,1500
2021-04-24,Toronto Maple Leafs,4,Winnipeg Jets,1,3,0,0,1500,1500
2021-04-25,Buffalo Sabres,3,New York Rangers,6,3,0,0,1500,1500
2021-04-25,New Jersey Devils,3,Philadelphia Flyers,4,1,1,0,1500,1500
2021-04-25,Boston Bruins,0,Pittsburgh Penguins,1,1,0,1,1500,1500
2021-04-25,Columbus Blue Jackets,3,Tampa Bay Lightning,4,1,0,0,1500,1500
2021-04-26,Montreal Canadiens,2,Calgary Flames,1,1,0,0,1500,1500
2021-04-26,Carolina Hurricanes,3,Dallas Stars,4,1,0,0,1500,1500
2021-04-26,Anaheim Ducks,1,Los Angeles Kings,4,3,0,0,1500,1500
2021-04-26,Florida Panthers,1,Nashville Predators,4,3,0,0,1500,1500
2021-04-26,Vancouver Canucks,1,Ottawa Senators,2,1,0,0,1500,1500
2021-04-26,Arizona Coyotes,4,San Jose Sharks,6,2,0,0,1500,1500
2021-04-26,Colorado Avalanche,1,St. Louis Blues,4,3,0,0,1500,1500
2021-04-26,Edmonton Oilers,6,Winnipeg Jets,1,5,0,0,1500,1500
2021-04-27,Detroit Red Wings,0,Columbus Blue Jackets,1,1,0,0,1500,1500
2021-04-27,Tampa Bay Lightning,7,Chicago Blackhawks,4,3,0,0,1500,1500
2021-04-27,Carolina Hurricanes,5,Dallas Stars,1,4,1,1,1500,1500
2021-04-27,Philadelphia Flyers,4,New Jersey Devils,6,2,0,0,1500,1500
2021-04-27,Florida Panthers,7,Nashville Predators,4,3,1,1,1500,1500
2021-04-27,Buffalo Sabres,1,New York Rangers,3,2,0,0,1500,1500
2021-04-27,Boston Bruins,3,Pittsburgh Penguins,1,2,0,0,1500,1500
2021-04-27,New York Islanders,0,Washington Capitals,1,1,0,0,1500,1500
2021-04-28,Anaheim Ducks,3,Los Angeles Kings,2,1,0,0,1500,1500
2021-04-28,St. Louis Blues,4,Minnesota Wild,3,1,0,0,1500,1500
2021-04-28,Toronto Maple Leafs,4,Montreal Canadiens,1,3,0,0,1500,1500
2021-04-28,Vancouver Canucks,3,Ottawa Senators,6,3,0,0,1500,1500
2021-04-28,Arizona Coyotes,2,San Jose Sharks,4,2,0,0,1500,1500
2021-04-28,Colorado Avalanche,2,Vegas Golden Knights,5,3,0,0,1500,1500
2021-04-28,Edmonton Oilers,3,Winnipeg Jets,1,2,0,0,1500,1500
2021-04-29,Buffalo Sabres,2,Boston Bruins,5,3,0,0,1500,1500
2021-04-29,Detroit Red Wings,1,Carolina Hurricanes,3,2,0,0,1500,1500
2021-04-29,Florida Panthers,4,Chicago Blackhawks,3,1,0,0,1500,1500
2021-04-29,Calgary Flames,3,Edmonton Oilers,1,2,0,1,1500,1500
2021-04-29,St. Louis Blues,5,Minnesota Wild,4,1,1,1,1500,1500
2021-04-29,Philadelphia Flyers,3,New Jersey Devils,5,2,0,0,1500,1500
2021-04-29,New York Islanders,4,New York Rangers,0,4,0,0,1500,1500
2021-04-29,Dallas Stars,0,Tampa Bay Lightning,3,3,0,0,1500,1500
2021-04-29,Vancouver Canucks,1,Toronto Maple Leafs,4,3,1,1,1500,1500
2021-04-29,Pittsburgh Penguins,5,Washington Capitals,4,1,0,0,1500,1500
2021-04-30,Los Angeles Kings,2,Anaheim Ducks,1,1,0,0,1500,1500
2021-04-30,Vegas Golden Knights,0,Arizona Coyotes,3,3,0,0,1500,1500
2021-04-30,San Jose Sharks,0,Colorado Avalanche,3,3,0,0,1500,1500
2021-04-30,Winnipeg Jets,3,Montreal Canadiens,5,2,0,0,1500,1500
2021-05-01,Los Angeles Kings,2,Anaheim Ducks,6,4,1,1,1500,1500
2021-05-01,Vegas Golden Knights,3,Arizona Coyotes,2,1,1,1,1500,1500
2021-05-01,Buffalo Sabres,2,Boston Bruins,6,4,0,0,1500,1500
2021-05-01,Columbus Blue Jackets,1,Carolina Hurricanes,2,1,0,0,1500,1500
2021-05-01,Florida Panthers,5,Chicago Blackhawks,4,1,0,0,1500,1500
2021-05-01,San Jose Sharks,3,Colorado Avalanche,4,1,1,1,1500,1500
2021-05-01,Tampa Bay Lightning,0,Detroit Red Wings,1,1,0,0,1500,1500
2021-05-01,Calgary Flames,1,Edmonton Oilers,4,3,0,0,1500,1500
2021-05-01,St. Louis Blues,3,Minnesota Wild,4,1,0,0,1500,1500
2021-05-01,Ottawa Senators,2,Montreal Canadiens,3,1,0,1,1500,1500
2021-05-01,Dallas Stars,0,Nashville Predators,1,1,0,0,1500,1500
2021-05-01,New York Rangers,0,New York Islanders,3,3,0,0,1500,1500
2021-05-01,New Jersey Devils,4,Philadelphia Flyers,1,3,0,0,1500,1500
2021-05-01,Vancouver Canucks,1,Toronto Maple Leafs,5,4,0,0,1500,1500
2021-05-01,Pittsburgh Penguins,3,Washington Capitals,0,3,0,0,1500,1500
2021-05-02,Tampa Bay Lightning,2,Detroit Red Wings,1,1,1,1,1500,1500
2021-05-03,Los Angeles Kings,3,Arizona Coyotes,2,1,0,0,1500,1500
2021-05-03,New York Islanders,2,Buffalo Sabres,4,2,0,0,1500,1500
2021-05-03,Chicago Blackhawks,2,Carolina Hurricanes,5,3,0,0,1500,1500
2021-05-03,Nashville Predators,4,Columbus Blue Jackets,3,1,0,0,1500,1500
2021-05-03,Dallas Stars,4,Florida Panthers,5,1,0,0,1500,1500
2021-05-03,Vegas Golden Knights,5,Minnesota Wild,6,1,0,0,1500,1500
2021-05-03,Toronto Maple Leafs,2,Montreal Canadiens,3,1,0,0,1500,1500
2021-05-03,Boston Bruins,3,New Jersey Devils,0,3,0,0,1500,1500
2021-05-03,Washington Capitals,6,New York Rangers,3,3,0,0,1500,1500
2021-05-03,Winnipeg Jets,1,Ottawa Senators,2,1,0,0,1500,1500
2021-05-03,Pittsburgh Penguins,2,Philadelphia Flyers,7,5,0,0,1500,1500
2021-05-03,Colorado Avalanche,5,San Jose Sharks,4,1,0,0,1500,1500
2021-05-03,Anaheim Ducks,1,St. Louis Blues,3,2,0,0,1500,1500
2021-05-03,Edmonton Oilers,5,Vancouver Canucks,3,2,0,0,1500,1500
2021-05-04,New York Islanders,3,Buffalo Sabres,4,1,1,1,1500,1500
2021-05-04,Chicago Blackhawks,3,Carolina Hurricanes,6,3,1,1,1500,1500
2021-05-04,Boston Bruins,3,New Jersey Devils,4,1,1,1,1500,1500
2021-05-04,Pittsburgh Penguins,7,Philadelphia Flyers,3,4,1,1,1500,1500
2021-05-04,Edmonton Oilers,4,Vancouver Canucks,1,3,1,1,1500,1500
2021-05-05,Los Angeles Kings,4,Arizona Coyotes,2,2,0,0,1500,1500
2021-05-05,Nashville Predators,2,Columbus Blue Jackets,4,2,0,0,1500,1500
2021-05-05,Winnipeg Jets,4,Calgary Flames,0,4,0,0,1500,1500
2021-05-05,Vegas Golden Knights,3,Minnesota Wild,2,1,0,0,1500,1500
2021-05-05,Washington Capitals,4,New York Rangers,2,2,0,0,1500,1500
2021-05-05,Montreal Canadiens,1,Ottawa Senators,5,4,0,0,1500,1500
2021-05-05,Colorado Avalanche,2,San Jose Sharks,3,1,0,0,1500,1500
2021-05-05,Anaheim Ducks,3,St. Louis Blues,2,1,0,0,1500,1500
2021-05-05,Dallas Stars,2,Tampa Bay Lightning,6,4,0,0,1500,1500
2021-05-06,New York Rangers,0,Boston Bruins,4,4,1,0,1500,1500
2021-05-06,Chicago Blackhawks,2,Carolina Hurricanes,1,1,0,0,1500,1500
2021-05-06,Vancouver Canucks,6,Edmonton Oilers,3,3,0,0,1500,1500
2021-05-06,New Jersey Devils,2,New York Islanders,1,1,0,0,1500,1500
2021-05-06,Buffalo Sabres,4,Pittsburgh Penguins,8,4,0,0,1500,1500
2021-05-06,Montreal Canadiens,2,Toronto Maple Leafs,5,3,1,0,1500,1500
2021-05-07,Detroit Red Wings,5,Columbus Blue Jackets,2,3,0,0,1500,1500
2021-05-07,Colorado Avalanche,3,Los Angeles Kings,2,1,0,0,1500,1500
2021-05-07,Anaheim Ducks,3,Minnesota Wild,4,1,0,0,1500,1500
2021-05-07,Arizona Coyotes,5,San Jose Sharks,2,3,0,0,1500,1500
2021-05-07,Dallas Stars,5,Tampa Bay Lightning,2,3,0,0,1500,1500
2021-05-07,St. Louis Blues,3,Vegas Golden Knights,4,1,0,0,1500,1500
2021-05-07,Philadelphia Flyers,4,Washington Capitals,2,2,0,0,1500,1500
2021-05-08,New York Rangers,5,Boston Bruins,4,1,0,0,1500,1500
2021-05-08,Detroit Red Wings,4,Columbus Blue Jackets,5,1,1,1,1500,1500
2021-05-08,Vancouver Canucks,3,Edmonton Oilers,4,1,0,0,1500,1500
2021-05-08,Tampa Bay Lightning,1,Florida Panthers,5,4,1,0,1500,1500
2021-05-08,Colorado Avalanche,3,Los Angeles Kings,2,1,1,1,1500,1500
2021-05-08,Anaheim Ducks,3,Minnesota Wild,4,1,1,1,1500,1500
2021-05-08,Carolina Hurricanes,1,Nashville Predators,3,2,0,0,1500,1500
2021-05-08,New Jersey Devils,1,New York Islanders,5,4,0,0,1500,1500
2021-05-08,Buffalo Sabres,0,Pittsburgh Penguins,1,1,0,0,1500,1500
2021-05-08,Arizona Coyotes,5,San Jose Sharks,4,1,1,1,1500,1500
2021-05-08,Montreal Canadiens,2,Toronto Maple Leafs,3,1,0,0,1500,1500
2021-05-08,St. Louis Blues,1,Vegas Golden Knights,4,3,1,1,1500,1500
2021-05-08,Ottawa Senators,4,Winnipeg Jets,2,2,0,0,1500,1500
2021-05-08,Philadelphia Flyers,1,Washington Capitals,2,1,1,1,1500,1500
2021-05-09,Ottawa Senators,1,Calgary Flames,6,5,1,0,1500,1500
2021-05-09,Dallas Stars,2,Chicago Blackhawks,4,2,0,0,1500,1500
2021-05-10,New York Islanders,2,Boston Bruins,3,1,0,0,1500,1500
2021-05-10,Dallas Stars,5,Chicago Blackhawks,4,1,1,1,1500,1500
2021-05-10,Tampa Bay Lightning,0,Florida Panthers,4,4,0,0,1500,1500
2021-05-10,St. Louis Blues,2,Los Angeles Kings,1,1,0,0,1500,1500
2021-05-10,Edmonton Oilers,4,Montreal Canadiens,3,1,0,0,1500,1500
2021-05-10,Carolina Hurricanes,0,Nashville Predators,5,5,0,0,1500,1500
2021-05-10,New Jersey Devils,2,Philadelphia Flyers,4,2,0,0,1500,1500
2021-05-10,Colorado Avalanche,2,Vegas Golden Knights,1,1,0,0,1500,1500
2021-05-10,Vancouver Canucks,3,Winnipeg Jets,1,2,0,0,1500,1500
2021-05-11,Vancouver Canucks,0,Winnipeg Jets,5,5,1,1,1500,1500
2021-05-11,Boston Bruins,1,Washington Capitals,2,1,1,0,1500,1500
2021-05-12,Los Angeles Kings,0,Colorado Avalanche,6,6,0,0,1500,1500
2021-05-12,Edmonton Oilers,4,Montreal Canadiens,3,1,0,0,1500,1500
2021-05-12,Toronto Maple Leafs,3,Ottawa Senators,4,1,0,0,1500,1500
2021-05-12,Vegas Golden Knights,6,San Jose Sharks,0,6,0,0,1500,1500
2021-05-12,Minnesota Wild,0,St. Louis Blues,4,4,0,0,1500,1500
2021-05-13,Vancouver Canucks,1,Calgary Flames,4,3,0,0,1500,1500
2021-05-13,Los Angeles Kings,1,Colorado Avalanche,5,4,1,1,1500,1500
2021-05-13,Minnesota Wild,3,St. Louis Blues,7,4,1,1,1500,1500
2021-05-14,Toronto Maple Leafs,2,Winnipeg Jets,4,2,0,0,1500,1500
2021-05-15,Vancouver Canucks,4,Edmonton Oilers,1,3,0,0,1500,1500
2021-05-16,Calgary Flames,6,Vancouver Canucks,5,1,0,1,1500,1500
2021-05-18,Calgary Flames,2,Vancouver Canucks,4,2,0,0,1500,1500
2021-05-19,Vancouver Canucks,2,Calgary Flames,6,4,1,1,1500,1500
