Date,Away,Away_Goals,Home,Home_Goals,MOV,Away_B2B,Home_B2B,Away_ELO,Home_ELO
2021-01-13,St. Louis Blues,4,Colorado Avalanche,1,3,0,0,1508.528,1491.472
2021-01-13,Vancouver Canucks,5,Edmonton Oilers,3,2,0,0,1508.528,1491.472
2021-01-13,Pittsburgh Penguins,3,Philadelphia Flyers,6,3,0,0,1492.528,1507.472
2021-01-13,Chicago Blackhawks,1,Tampa Bay Lightning,5,4,0,0,1492.528,1507.472
2021-01-13,Montreal Canadiens,4,Toronto Maple Leafs,5,1,0,0,1492.528,1507.472
2021-01-14,San Jose Sharks,4,Arizona Coyotes,3,1,0,0,1508.528,1491.472
2021-01-14,Washington Capitals,6,Buffalo Sabres,4,2,0,0,1508.528,1491.472
2021-01-14,Carolina Hurricanes,3,Detroit Red Wings,0,3,0,0,1508.528,1491.472
2021-01-14,Vancouver Canucks,2,Edmonton Oilers,5,3,1,1,1500.6635862667608,1499.3364137332392
2021-01-14,Minnesota Wild,4,Los Angeles Kings,3,1,0,0,1508.528,1491.472
2021-01-14,Boston Bruins,3,New Jersey Devils,2,1,0,0,1508.528,1491.472
2021-01-14,Columbus Blue Jackets,1,Nashville Predators,3,2,0,0,1492.528,1507.472
2021-01-14,New York Islanders,4,New York Rangers,0,4,0,0,1508.528,1491.472
2021-01-14,Anaheim Ducks,2,Vegas Golden Knights,5,3,0,0,1492.528,1507.472
2021-01-14,Calgary Flames,3,Winnipeg Jets,4,1,0,0,1492.528,1507.472
2021-01-15,Washington Capitals,2,Buffalo Sabres,1,1,1,1,1516.6635862667608,1483.3364137332392
2021-01-15,St. Louis Blues,0,Colorado Avalanche,8,8,0,0,1500.6635862667608,1499.3364137332392
2021-01-15,Toronto Maple Leafs,3,Ottawa Senators,5,2,0,0,1499.8279773620084,1507.6440226379916
2021-01-15,Pittsburgh Penguins,2,Philadelphia Flyers,5,3,0,0,1485.3998862727074,1514.6001137272926
2021-01-15,Chicago Blackhawks,2,Tampa Bay Lightning,5,3,0,0,1485.3998862727074,1514.6001137272926
2021-01-16,San Jose Sharks,3,Arizona Coyotes,5,2,0,0,1500.6635862667608,1499.3364137332392
2021-01-16,Vancouver Canucks,0,Calgary Flames,3,3,0,0,1493.0042917009634,1500.1872945657974
2021-01-16,Carolina Hurricanes,2,Detroit Red Wings,4,2,0,0,1500.6635862667608,1499.3364137332392
2021-01-16,Montreal Canadiens,5,Edmonton Oilers,1,4,0,0,1501.2127494557171,1490.651664277522
2021-01-16,Minnesota Wild,4,Los Angeles Kings,3,1,0,0,1516.6635862667608,1483.3364137332392
2021-01-16,Boston Bruins,1,New Jersey Devils,2,1,0,0,1500.6635862667608,1499.3364137332392
2021-01-16,Columbus Blue Jackets,2,Nashville Predators,5,3,0,0,1485.3998862727074,1514.6001137272926
2021-01-16,New York Islanders,0,New York Rangers,5,5,0,0,1500.6635862667608,1499.3364137332392
2021-01-16,Toronto Maple Leafs,3,Ottawa Senators,2,1,1,1,1508.535918101171,1498.936081898829
2021-01-16,Anaheim Ducks,1,Vegas Golden Knights,2,1,0,0,1485.3998862727074,1514.6001137272926
2021-01-17,Chicago Blackhawks,2,Florida Panthers,5,3,0,0,1478.2638685688655,1507.1360177038418
2021-01-17,Washington Capitals,3,Pittsburgh Penguins,4,1,0,0,1508.4736496725916,1493.5898228668766
2021-01-18,Minnesota Wild,0,Anaheim Ducks,1,1,0,0,1508.4736496725916,1493.5898228668766
2021-01-18,Vancouver Canucks,2,Calgary Flames,5,3,0,0,1485.697662893376,1507.4939233733849
2021-01-18,Columbus Blue Jackets,3,Detroit Red Wings,2,1,0,0,1494.2486146758245,1490.487685330122
2021-01-18,Montreal Canadiens,3,Edmonton Oilers,1,2,0,0,1509.4976463532898,1482.3667673799494
2021-01-18,Carolina Hurricanes,4,Nashville Predators,2,2,0,0,1509.512314669878,1505.7513853241755
2021-01-18,Boston Bruins,0,New York Islanders,1,1,0,0,1493.1915862667609,1508.1355862667608
2021-01-18,Buffalo Sabres,6,Philadelphia Flyers,1,5,0,0,1492.5823503274082,1505.3541771331236
2021-01-18,San Jose Sharks,4,St. Louis Blues,5,1,0,0,1493.1915862667609,1508.1355862667608
2021-01-18,Winnipeg Jets,1,Toronto Maple Leafs,3,2,0,0,1500.0244975430273,1515.9834205581437
2021-01-18,Arizona Coyotes,2,Vegas Golden Knights,4,2,0,0,1492.21564747549,1521.7208799850418
2021-01-19,Columbus Blue Jackets,2,Detroit Red Wings,3,1,1,1,1486.6900194596435,1498.046280546303
2021-01-19,Chicago Blackhawks,4,Florida Panthers,5,1,0,0,1471.4551482630488,1513.9447380096585
2021-01-19,Colorado Avalanche,3,Los Angeles Kings,2,1,0,0,1507.4962603364781,1475.1765671300002
2021-01-19,New Jersey Devils,4,New York Rangers,3,1,0,0,1507.8644137332392,1490.8084137332391
2021-01-19,Winnipeg Jets,4,Ottawa Senators,3,1,1,0,1510.127435928638,1488.8331435132181
2021-01-19,Buffalo Sabres,0,Philadelphia Flyers,3,3,1,1,1485.4043001129567,1512.5322273475751
2021-01-19,Washington Capitals,4,Pittsburgh Penguins,5,1,0,0,1500.6591463890002,1501.404326150468
2021-01-20,Minnesota Wild,3,Anaheim Ducks,2,1,0,0,1516.6591463890002,1485.404326150468
2021-01-20,San Jose Sharks,2,St. Louis Blues,1,1,0,0,1502.0634725394682,1499.2636999940535
2021-01-20,Edmonton Oilers,3,Toronto Maple Leafs,1,2,0,0,1491.6664129237588,1506.6837750143343
2021-01-20,Montreal Canadiens,5,Vancouver Canucks,6,1,0,0,1501.4784870635629,1493.716822183103
2021-01-20,Arizona Coyotes,2,Vegas Golden Knights,5,3,0,0,1485.4214020451204,1528.5151254154114
2021-01-21,Philadelphia Flyers,4,Boston Bruins,5,1,0,0,1504.6153520603314,1501.1084615540046
2021-01-21,Tampa Bay Lightning,3,Columbus Blue Jackets,2,1,0,0,1522.4868388855602,1478.803294301376
2021-01-21,Colorado Avalanche,2,Los Angeles Kings,4,2,0,0,1499.2822110766715,1483.3906163898068
2021-01-21,New Jersey Devils,1,New York Islanders,4,3,0,0,1500.3986577103044,1515.6013422896956
2021-01-21,Winnipeg Jets,4,Ottawa Senators,1,3,0,0,1518.1657297582058,1480.7948496836505
2021-01-21,Montreal Canadiens,7,Vancouver Canucks,3,4,1,1,1509.8277978501906,1485.3675113964753
2021-01-22,Colorado Avalanche,3,Anaheim Ducks,2,1,1,0,1509.0908308066003,1475.5957064205393
2021-01-22,Vegas Golden Knights,2,Arizona Coyotes,5,3,0,0,1520.0559131235964,1493.8806143369354
2021-01-22,Detroit Red Wings,1,Chicago Blackhawks,4,3,0,0,1489.9631898223108,1479.538238987041
2021-01-22,Nashville Predators,0,Dallas Stars,7,7,0,0,1498.1469668783323,1507.6044184458433
2021-01-22,San Jose Sharks,1,Minnesota Wild,4,3,0,0,1494.9273527839264,1523.795266144542
2021-01-22,New York Rangers,3,Pittsburgh Penguins,4,1,0,0,1483.5803180195194,1508.6324218641878
2021-01-22,Edmonton Oilers,2,Toronto Maple Leafs,4,2,0,0,1484.5399852843873,1513.8102026537058
2021-01-22,Buffalo Sabres,3,Washington Capitals,4,1,0,0,1478.2833303835537,1507.7801161184032
2021-01-23,Philadelphia Flyers,1,Boston Bruins,6,5,0,0,1497.0626056644776,1508.6612079498584
2021-01-23,Tampa Bay Lightning,2,Columbus Blue Jackets,5,3,0,0,1514.014255085167,1487.2758781017692
2021-01-23,Los Angeles Kings,2,St. Louis Blues,4,2,0,0,1476.283853568531,1506.3704628153293
2021-01-23,Montreal Canadiens,5,Vancouver Canucks,2,3,0,0,1517.7935076295905,1477.4018016170753
2021-01-23,Ottawa Senators,3,Winnipeg Jets,6,3,0,0,1474.1800427529001,1524.780536688956
2021-01-24,Colorado Avalanche,1,Anaheim Ducks,3,2,0,0,1500.8499576254844,1483.836579601655
2021-01-24,Vegas Golden Knights,1,Arizona Coyotes,0,1,0,0,1527.98234231707,1485.9541851434617
2021-01-24,Toronto Maple Leafs,3,Calgary Flames,2,1,0,0,1522.19278096893,1499.1113450581606
2021-01-24,Detroit Red Wings,2,Chicago Blackhawks,6,4,0,0,1482.2512184715265,1487.2502103378254
2021-01-24,Nashville Predators,2,Dallas Stars,3,1,0,0,1490.8926789783675,1514.858706345808
2021-01-24,San Jose Sharks,5,Minnesota Wild,3,2,0,0,1504.118535616146,1514.6040833123225
2021-01-24,New York Islanders,0,New Jersey Devils,2,2,0,0,1507.7795107819654,1508.2204892180346
2021-01-24,New York Rangers,2,Pittsburgh Penguins,3,1,0,0,1476.6841663827222,1515.528573500985
2021-01-24,Los Angeles Kings,6,St. Louis Blues,3,3,1,1,1485.5028968548154,1497.151419529045
2021-01-24,Edmonton Oilers,4,Winnipeg Jets,3,1,0,1,1492.3904371179194,1516.930084855424
2021-01-24,Buffalo Sabres,4,Washington Capitals,3,1,0,0,1487.4888918545666,1498.57455464739
2021-01-25,Ottawa Senators,1,Vancouver Canucks,7,6,0,0,1466.78222436601,1484.7996200039654
2021-01-26,Anaheim Ducks,1,Arizona Coyotes,0,1,0,0,1492.413338667415,1477.3774260777018
2021-01-26,Pittsburgh Penguins,2,Boston Bruins,3,1,0,0,1507.89846715515,1516.2913142956934
2021-01-26,New York Rangers,2,Buffalo Sabres,3,1,0,0,1469.460874209448,1494.7121840278407
2021-01-26,Florida Panthers,4,Columbus Blue Jackets,3,1,0,0,1521.859868014337,1479.3607480970907
2021-01-26,Toronto Maple Leafs,4,Calgary Flames,3,1,0,0,1530.19009175813,1491.1140342689607
2021-01-26,San Jose Sharks,3,Colorado Avalanche,7,4,0,0,1496.5712760468564,1508.397217194774
2021-01-26,Detroit Red Wings,1,Dallas Stars,2,1,0,0,1475.5278369278972,1521.5820878894374
2021-01-26,Los Angeles Kings,2,Minnesota Wild,1,1,0,0,1494.6994137889546,1505.4075663781832
2021-01-26,Philadelphia Flyers,5,New Jersey Devils,3,2,0,0,1505.8474371377401,1499.435657744772
2021-01-26,Chicago Blackhawks,2,Nashville Predators,3,1,0,0,1479.8620782051016,1498.2808111110912
2021-01-26,St. Louis Blues,5,Vegas Golden Knights,4,1,0,0,1506.3874702148246,1518.7462916312904
2021-01-26,Edmonton Oilers,4,Winnipeg Jets,6,2,0,0,1485.482545642928,1523.8379763304154
2021-01-26,New York Islanders,2,Washington Capitals,3,1,0,0,1500.0956084122035,1506.2584570171518
2021-01-27,Chicago Blackhawks,1,Nashville Predators,2,1,1,1,1472.813788343477,1505.3291009727159
2021-01-27,Ottawa Senators,1,Vancouver Canucks,5,4,0,0,1459.7247187354114,1491.857125634564
2021-01-28,Anaheim Ducks,2,Arizona Coyotes,3,1,0,0,1484.5953399637626,1485.1954247813542
2021-01-28,Pittsburgh Penguins,1,Boston Bruins,4,3,0,0,1500.6196820209323,1523.5700994299111
2021-01-28,New York Rangers,3,Buffalo Sabres,2,1,0,0,1478.5692855049847,1485.6037727323042
2021-01-28,Tampa Bay Lightning,0,Carolina Hurricanes,1,1,0,0,1506.438599877443,1517.0879698776018
2021-01-28,Florida Panthers,2,Columbus Blue Jackets,3,1,0,0,1513.4141413183238,1487.806474793104
2021-01-28,San Jose Sharks,0,Colorado Avalanche,3,3,0,0,1489.371473292965,1515.5970199486653
2021-01-28,Detroit Red Wings,3,Dallas Stars,7,4,0,0,1469.110107682416,1527.9998171349187
2021-01-28,Toronto Maple Leafs,4,Edmonton Oilers,3,1,0,0,1537.6943069153458,1477.9783304857121
2021-01-28,Los Angeles Kings,3,Minnesota Wild,5,2,0,0,1487.473900072907,1512.6330800942308
2021-01-28,Calgary Flames,2,Montreal Canadiens,4,2,0,0,1484.25514721323,1524.6523946853213
2021-01-28,Philadelphia Flyers,3,New Jersey Devils,1,2,0,0,1514.22781721925,1491.0552776632621
2021-01-28,Ottawa Senators,1,Vancouver Canucks,4,3,1,1,1452.9904924581044,1498.591351911871
2021-01-28,New York Islanders,3,Washington Capitals,6,3,0,0,1492.7654983643629,1513.5885670649925
2021-01-29,Columbus Blue Jackets,2,Chicago Blackhawks,1,1,1,0,1497.5894695516583,1463.0307935849225
2021-01-30,St. Louis Blues,6,Anaheim Ducks,1,5,0,0,1514.4143448671412,1476.568465311446
2021-01-30,New Jersey Devils,3,Buffalo Sabres,4,1,0,0,1483.4577624237356,1493.2012879718307
2021-01-30,Dallas Stars,1,Carolina Hurricanes,4,3,0,0,1520.2766451455507,1524.8111418669698
2021-01-30,Florida Panthers,3,Detroit Red Wings,2,1,0,0,1520.9274968847942,1461.5967521159455
2021-01-30,Toronto Maple Leafs,3,Edmonton Oilers,4,1,0,0,1528.8606776003146,1486.8119598007434
2021-01-30,Colorado Avalanche,5,Minnesota Wild,1,4,0,0,1524.0567743669583,1504.1733256759378
2021-01-30,Calgary Flames,2,Montreal Canadiens,0,2,0,0,1493.709158950414,1515.1983829481374
2021-01-30,Pittsburgh Penguins,5,New York Rangers,4,1,0,0,1508.6406334840044,1470.5483340419125
2021-01-30,New York Islanders,2,Philadelphia Flyers,3,1,0,0,1485.7870588749265,1521.2062567086864
2021-01-30,Nashville Predators,3,Tampa Bay Lightning,4,1,0,0,1497.8826480422622,1513.8850528078967
2021-01-30,Vancouver Canucks,4,Winnipeg Jets,1,3,0,0,1507.6996558898609,1514.7296723524255
2021-01-30,Boston Bruins,3,Washington Capitals,4,1,0,0,1515.8683293648392,1521.2903371300645
2021-01-31,St. Louis Blues,4,Anaheim Ducks,1,3,1,1,1522.0743416910275,1468.9084684875597
2021-01-31,New Jersey Devils,5,Buffalo Sabres,3,2,1,1,1492.2100565932062,1484.44899380236
2021-01-31,Dallas Stars,3,Carolina Hurricanes,4,1,1,1,1512.9090498631642,1532.1787371493563
2021-01-31,Columbus Blue Jackets,1,Chicago Blackhawks,3,2,0,0,1489.3243406080824,1471.2959225284985
2021-01-31,Florida Panthers,3,Detroit Red Wings,2,1,1,1,1528.102482512947,1454.4217664877926
2021-01-31,Ottawa Senators,5,Edmonton Oilers,8,3,0,1,1444.694809879702,1495.1076423791458
2021-01-31,Colorado Avalanche,3,Minnesota Wild,4,1,1,1,1516.1274402159363,1512.1026598269598
2021-01-31,New York Islanders,3,Philadelphia Flyers,4,1,1,1,1479.1278024567569,1527.865513126856
2021-02-01,Vancouver Canucks,2,Montreal Canadiens,6,4,0,0,1500.400293655544,1522.4977451824543
2021-02-01,Pittsburgh Penguins,1,New York Rangers,3,2,0,0,1500.2950235092876,1478.8939440166293
2021-02-01,Nashville Predators,2,Tampa Bay Lightning,5,3,0,0,1490.7788566935162,1520.9888441566427
2021-02-01,Calgary Flames,4,Winnipeg Jets,3,1,0,0,1502.7205844459163,1505.718246856923
2021-02-01,Boston Bruins,5,Washington Capitals,3,2,0,0,1524.5211655733112,1512.6375009215924
2021-02-02,Dallas Stars,6,Columbus Blue Jackets,3,3,0,0,1520.894824466073,1481.3385660051736
2021-02-02,Carolina Hurricanes,4,Chicago Blackhawks,3,1,0,0,1539.319033725168,1464.1556259526867
2021-02-02,Minnesota Wild,1,Colorado Avalanche,2,1,0,0,1504.7233296749878,1523.5067703679083
2021-02-02,Ottawa Senators,2,Edmonton Oilers,4,2,0,0,1438.3755298083167,1501.426922450531
2021-02-02,Anaheim Ducks,3,Los Angeles Kings,1,2,0,0,1477.8635469368865,1478.5188216235804
2021-02-02,Vancouver Canucks,3,Montreal Canadiens,5,2,1,1,1493.436421312351,1529.4616175256472
2021-02-02,Arizona Coyotes,3,St. Louis Blues,4,1,0,0,1478.5694183429516,1528.70034812943
2021-02-02,Calgary Flames,2,Winnipeg Jets,3,1,1,1,1495.3176064610313,1513.121224841808
2021-02-03,Boston Bruins,4,Philadelphia Flyers,3,1,0,0,1533.1261696432518,1519.2605090569155
2021-02-03,Detroit Red Wings,1,Tampa Bay Lightning,5,4,0,0,1448.4640461444312,1526.9465645000041
2021-02-04,Dallas Stars,3,Columbus Blue Jackets,4,1,0,0,1512.5159230803838,1489.7174673908628
2021-02-04,Carolina Hurricanes,4,Chicago Blackhawks,6,2,0,0,1530.1428363270372,1473.3318233508176
2021-02-04,Nashville Predators,6,Florida Panthers,5,1,0,0,1500.1629741697197,1518.7183650367435
2021-02-04,Ottawa Senators,3,Montreal Canadiens,2,1,0,0,1448.9540988244144,1518.8830485095496
2021-02-04,Washington Capitals,2,New York Rangers,4,2,0,0,1504.3909605996337,1487.140484338588
2021-02-04,Arizona Coyotes,4,St. Louis Blues,3,1,0,0,1488.2437812465973,1519.0259852257843
2021-02-04,Vancouver Canucks,3,Toronto Maple Leafs,7,4,0,0,1486.7772801670678,1535.5198187455978
2021-02-04,Calgary Flames,1,Winnipeg Jets,4,3,0,0,1488.255191485293,1520.1836398175465
2021-02-05,San Jose Sharks,5,Anaheim Ducks,4,1,0,0,1497.6345903566348,1469.6004298732166
2021-02-05,Nashville Predators,1,Florida Panthers,2,1,1,1,1493.1178220815018,1525.7635171249615
2021-02-05,Boston Bruins,2,Philadelphia Flyers,1,1,0,0,1541.3350704007842,1511.0516082993831
2021-02-05,Detroit Red Wings,1,Tampa Bay Lightning,3,2,0,0,1442.769050362051,1532.6415602823843
2021-02-05,Los Angeles Kings,2,Vegas Golden Knights,5,3,0,0,1471.968976250295,1525.2961370045757
2021-02-06,San Jose Sharks,1,Anaheim Ducks,2,1,1,1,1489.5184772220605,1477.716543007791
2021-02-06,Edmonton Oilers,4,Calgary Flames,6,2,0,0,1493.651777356286,1496.030336579538
2021-02-06,Pittsburgh Penguins,3,New York Islanders,4,1,0,0,1492.3362323666122,1487.0865935994323
2021-02-06,Montreal Canadiens,2,Ottawa Senators,1,1,0,0,1525.822271167351,1442.014876166613
2021-02-06,Arizona Coyotes,3,St. Louis Blues,1,2,0,0,1497.4787189139547,1509.791047558427
2021-02-06,Vancouver Canucks,1,Toronto Maple Leafs,5,4,0,0,1480.4203128431839,1541.8767860694818
2021-02-07,Carolina Hurricanes,6,Columbus Blue Jackets,5,1,0,0,1537.7441857509418,1482.1161179669582
2021-02-07,Chicago Blackhawks,2,Dallas Stars,1,1,0,0,1482.7582645654863,1503.089481865715
2021-02-07,Detroit Red Wings,4,Florida Panthers,1,3,0,0,1453.1725304517745,1515.360037035238
2021-02-07,Los Angeles Kings,3,Vegas Golden Knights,4,1,0,0,1465.7153269767239,1531.549786278147
2021-02-07,Philadelphia Flyers,7,Washington Capitals,4,3,0,0,1519.426260004225,1496.0163088947918
2021-02-08,Carolina Hurricanes,2,Columbus Blue Jackets,3,1,1,1,1529.0021363748867,1490.8581673430133
2021-02-08,Tampa Bay Lightning,4,Nashville Predators,1,3,0,0,1540.2633980882094,1485.4959842756766
2021-02-08,New York Islanders,2,New York Rangers,0,2,0,0,1495.6158344795485,1478.6112434584718
2021-02-08,Edmonton Oilers,3,Ottawa Senators,1,2,0,0,1500.9994715021492,1434.6671820207498
2021-02-08,Arizona Coyotes,4,St. Louis Blues,3,1,0,0,1506.2901021405416,1500.97966433184
2021-02-08,Vancouver Canucks,1,Toronto Maple Leafs,3,2,0,0,1474.3488241149482,1547.9482747977174
2021-02-09,Winnipeg Jets,2,Calgary Flames,3,1,0,0,1512.156383661941,1504.0575927351435
2021-02-09,Chicago Blackhawks,2,Dallas Stars,1,1,0,0,1491.7538745126772,1494.0938719185242
2021-02-09,Detroit Red Wings,1,Florida Panthers,2,1,0,0,1447.1173524795718,1521.4152150074408
2021-02-09,San Jose Sharks,4,Los Angeles Kings,3,1,0,0,1497.4992453555499,1457.7345588432345
2021-02-09,Tampa Bay Lightning,6,Nashville Predators,1,5,1,1,1547.5406740971562,1478.21870826673
2021-02-09,Edmonton Oilers,3,Ottawa Senators,2,1,1,1,1508.0184050118055,1427.6482485110935
2021-02-09,Anaheim Ducks,4,Vegas Golden Knights,5,1,0,0,1471.4742739098251,1537.7920553761128
2021-02-10,Toronto Maple Leafs,4,Montreal Canadiens,2,2,0,0,1555.9674923601324,1517.803053604936
2021-02-10,Boston Bruins,3,New York Rangers,2,1,0,0,1548.4342897576023,1471.5120241016537
2021-02-11,Columbus Blue Jackets,6,Chicago Blackhawks,5,1,0,0,1499.4067917170867,1483.2052501386038
2021-02-11,Carolina Hurricanes,5,Dallas Stars,3,2,0,0,1536.729037775504,1486.366970517907
2021-02-11,Tampa Bay Lightning,2,Florida Panthers,5,3,0,0,1539.4682444152613,1529.4876446893356
2021-02-11,San Jose Sharks,2,Los Angeles Kings,6,4,0,0,1489.1156067347567,1466.1181974640276
2021-02-11,Edmonton Oilers,3,Montreal Canadiens,0,3,0,1,1515.1716453269214,1510.64981328982
2021-02-11,Detroit Red Wings,2,Nashville Predators,3,1,0,0,1440.3595809104281,1484.9764798358735
2021-02-11,Pittsburgh Penguins,4,New York Islanders,3,1,0,0,1500.9397457531572,1487.0123210930035
2021-02-11,Calgary Flames,3,Vancouver Canucks,1,2,0,0,1511.903185442195,1466.5032314078967
2021-02-11,Anaheim Ducks,1,Vegas Golden Knights,0,1,0,0,1481.511018224915,1527.755311061023
2021-02-11,Ottawa Senators,1,Winnipeg Jets,5,4,0,0,1422.0846327476627,1517.7199994253717
2021-02-12,St. Louis Blues,4,Arizona Coyotes,1,3,0,0,1509.6299321598963,1497.6398343124854
2021-02-12,Boston Bruins,1,New York Rangers,0,1,0,0,1555.219472971629,1464.7268408876268
2021-02-13,St. Louis Blues,5,Arizona Coyotes,4,1,1,1,1517.881959502914,1489.3878069694676
2021-02-13,Columbus Blue Jackets,2,Chicago Blackhawks,3,1,0,0,1491.5620076059577,1491.0500342497328
2021-02-13,Carolina Hurricanes,4,Dallas Stars,3,1,0,0,1544.1054625149893,1478.9905457784216
2021-02-13,Tampa Bay Lightning,6,Florida Panthers,1,5,0,0,1547.7664958072828,1521.1893932973142
2021-02-13,Detroit Red Wings,4,Nashville Predators,2,2,0,0,1449.9093126388152,1475.4267481074864
2021-02-13,Boston Bruins,2,New York Islanders,4,2,1,0,1547.7968150280833,1494.4349790365493
2021-02-13,Vegas Golden Knights,3,San Jose Sharks,1,2,0,0,1535.3972490828705,1481.473668712909
2021-02-13,Montreal Canadiens,2,Toronto Maple Leafs,1,1,0,0,1520.215413764709,1546.4018918852435
2021-02-13,Calgary Flames,1,Vancouver Canucks,3,2,0,0,1503.3917224421455,1475.0146944079463
2021-02-13,Ottawa Senators,2,Winnipeg Jets,1,1,0,0,1432.7607376587737,1507.0438945142607
2021-02-14,Washington Capitals,3,Pittsburgh Penguins,6,3,0,0,1488.657667630152,1508.298387017797
2021-02-14,Colorado Avalanche,0,Vegas Golden Knights,1,1,0,1,1514.708451916671,1544.1955675341078
2021-02-15,St. Louis Blues,0,Arizona Coyotes,1,1,0,0,1509.755324448764,1497.5144420236177
2021-02-15,New York Islanders,3,Buffalo Sabres,1,2,0,0,1502.73310652499,1476.1508663139193
2021-02-15,Columbus Blue Jackets,3,Carolina Hurricanes,7,4,0,0,1485.2907253475285,1550.3767447734185
2021-02-15,Chicago Blackhawks,3,Detroit Red Wings,2,1,0,0,1498.6351369650224,1442.3242099235256
2021-02-15,Winnipeg Jets,6,Edmonton Oilers,5,1,0,0,1515.7590087608544,1506.4565310803277
2021-02-15,Anaheim Ducks,2,San Jose Sharks,3,1,0,0,1474.0381582206226,1488.9465287172015
2021-02-15,Florida Panthers,6,Tampa Bay Lightning,4,2,0,0,1530.3281628577886,1538.6277262468084
2021-02-15,Ottawa Senators,6,Toronto Maple Leafs,5,1,0,0,1443.8159342516406,1535.3466952923766
2021-02-15,Calgary Flames,4,Vancouver Canucks,3,1,0,0,1511.2677662945405,1467.1386505555513
2021-02-16,New York Islanders,3,Buffalo Sabres,0,3,1,1,1510.6502193542485,1468.2337534846608
2021-02-16,Minnesota Wild,0,Los Angeles Kings,4,4,0,0,1496.3660539924758,1474.4754731465396
2021-02-16,New Jersey Devils,5,New York Rangers,2,3,0,0,1500.1065487926192,1456.830348688214
2021-02-16,Washington Capitals,3,Pittsburgh Penguins,1,2,0,0,1497.6374307760589,1499.3186238718902
2021-02-16,Colorado Avalanche,3,Vegas Golden Knights,2,1,0,0,1523.9137923217015,1534.9902271290773
2021-02-17,Florida Panthers,4,Carolina Hurricanes,3,1,0,0,1539.317286812392,1541.387620818815
2021-02-17,Vancouver Canucks,5,Calgary Flames,1,4,0,0,1476.677331891408,1501.7290849586839
2021-02-17,Chicago Blackhawks,2,Detroit Red Wings,0,2,0,0,1505.8777652596066,1435.0815816289414
2021-02-17,Winnipeg Jets,2,Edmonton Oilers,3,1,0,0,1508.0728624667172,1514.142677374465
2021-02-17,Ottawa Senators,1,Toronto Maple Leafs,2,1,0,0,1438.404066400487,1540.7585631435302
2021-02-18,Minnesota Wild,3,Anaheim Ducks,1,2,0,0,1504.3806417908193,1466.0235704222791
2021-02-18,Los Angeles Kings,3,Arizona Coyotes,2,1,0,0,1483.533188812832,1488.4567263573254
2021-02-18,New Jersey Devils,3,Boston Bruins,2,1,0,0,1509.7258127361167,1538.1775510845857
2021-02-18,Nashville Predators,0,Columbus Blue Jackets,3,3,0,0,1468.181813572471,1492.535659882544
2021-02-18,New York Rangers,3,Philadelphia Flyers,2,1,0,0,1466.784277726502,1509.4723309659369
2021-02-18,New York Islanders,1,Pittsburgh Penguins,4,3,0,0,1502.917392202989,1507.0514510231496
2021-02-18,San Jose Sharks,2,St. Louis Blues,3,1,0,0,1481.953096856231,1516.7487563097345
2021-02-18,Ottawa Senators,3,Toronto Maple Leafs,7,4,1,1,1433.222970915034,1545.9396586289831
2021-02-18,Buffalo Sabres,1,Washington Capitals,3,2,0,0,1461.4371863850636,1504.4339978756561
2021-02-19,Chicago Blackhawks,3,Carolina Hurricanes,5,2,0,0,1499.2205747128414,1548.0448113655802
2021-02-19,Edmonton Oilers,2,Calgary Flames,1,1,0,0,1522.3849654132398,1493.486796919909
2021-02-19,Florida Panthers,7,Detroit Red Wings,2,5,0,0,1545.5146799320096,1428.8841885093238
2021-02-19,Winnipeg Jets,2,Vancouver Canucks,0,2,0,0,1515.8799149108238,1468.8702794473013
2021-02-20,Minnesota Wild,5,Anaheim Ducks,1,4,0,0,1512.029008421031,1458.3752037920674
2021-02-20,Los Angeles Kings,4,Arizona Coyotes,2,2,0,0,1492.1745498661105,1479.8153653040467
2021-02-20,Tampa Bay Lightning,0,Carolina Hurricanes,4,4,0,1,1529.772509560449,1556.9000280519397
2021-02-20,Nashville Predators,4,Columbus Blue Jackets,2,2,0,0,1477.2696649734683,1483.4478084815466
2021-02-20,Vegas Golden Knights,2,Colorado Avalanche,3,1,0,0,1527.2632691636363,1531.6407502871425
2021-02-20,Florida Panthers,1,Detroit Red Wings,2,1,1,1,1535.4536897099094,1438.945178731424
2021-02-20,Calgary Flames,1,Edmonton Oilers,7,6,1,1,1486.6786716098904,1529.1930907232584
2021-02-20,Toronto Maple Leafs,5,Montreal Canadiens,3,2,0,0,1553.8764159983152,1512.2786563953769
2021-02-20,Buffalo Sabres,3,New Jersey Devils,2,1,0,0,1471.0699685257196,1500.0930305954607
2021-02-20,New York Islanders,2,Pittsburgh Penguins,3,1,0,0,1495.5405779329992,1514.4282652931395
2021-02-20,San Jose Sharks,5,St. Louis Blues,4,1,0,0,1491.2796285459062,1507.4222246200593
2021-02-20,New York Rangers,4,Washington Capitals,1,3,0,0,1476.175817064938,1495.0424585372202
2021-02-21,Philadelphia Flyers,3,Boston Bruins,7,4,0,0,1502.6597932474135,1544.990088803109
2021-02-21,Montreal Canadiens,2,Ottawa Senators,3,1,1,0,1504.617110293518,1440.884517016893
2021-02-21,Winnipeg Jets,4,Vancouver Canucks,3,1,0,0,1523.3320355484661,1461.418158809659
2021-02-21,New Jersey Devils,3,Washington Capitals,4,1,1,1,1492.504745067022,1502.630744065659
2021-02-22,Anaheim Ducks,3,Arizona Coyotes,4,1,0,0,1451.39625605089,1486.794313045224
2021-02-22,Tampa Bay Lightning,4,Carolina Hurricanes,2,2,0,0,1538.9238775106717,1547.748660101717
2021-02-22,Vegas Golden Knights,3,Colorado Avalanche,0,3,0,0,1535.892059058195,1523.011960392584
2021-02-22,Dallas Stars,1,Florida Panthers,3,2,0,0,1472.807331685986,1541.6369038023452
2021-02-22,Buffalo Sabres,2,New York Islanders,3,1,0,0,1464.1604952663652,1502.4500511923536
2021-02-22,Minnesota Wild,6,San Jose Sharks,2,4,0,0,1520.0798035007654,1483.2288334661719
2021-02-22,Los Angeles Kings,3,St. Louis Blues,0,3,0,0,1501.053415324093,1498.5433591620767
2021-02-22,Calgary Flames,3,Toronto Maple Leafs,0,3,0,0,1496.734947787164,1543.8201398210417
2021-02-23,Chicago Blackhawks,6,Columbus Blue Jackets,5,1,0,0,1507.385642642697,1475.2827405516912
2021-02-23,Nashville Predators,2,Detroit Red Wings,0,2,0,0,1484.918772840517,1431.2960708643752
2021-02-23,Buffalo Sabres,4,New Jersey Devils,1,3,1,0,1474.9397016740306,1481.7255386593565
2021-02-23,Montreal Canadiens,4,Ottawa Senators,5,1,0,0,1495.6938545610185,1449.8077727493924
2021-02-23,Edmonton Oilers,4,Vancouver Canucks,3,1,0,0,1536.1800134027442,1454.4312361301731
2021-02-23,Pittsburgh Penguins,3,Washington Capitals,2,1,0,0,1522.6847216841243,1494.3742876746742
2021-02-24,Anaheim Ducks,3,Arizona Coyotes,4,1,0,0,1444.736517868104,1493.45405122801
2021-02-24,Minnesota Wild,6,Colorado Avalanche,2,4,0,0,1528.6753173054014,1514.4164465879478
2021-02-24,Dallas Stars,3,Florida Panthers,0,3,0,0,1482.8997781249036,1531.5444573634275
2021-02-24,New York Rangers,3,Philadelphia Flyers,4,1,0,0,1469.3124547675488,1509.5231555448026
2021-02-24,Los Angeles Kings,2,St. Louis Blues,1,1,0,0,1509.5236201505923,1490.0731543355776
2021-02-24,Carolina Hurricanes,0,Tampa Bay Lightning,3,3,0,0,1540.0735056596427,1546.599031952746
2021-02-24,Calgary Flames,1,Toronto Maple Leafs,2,1,0,0,1490.3405353883268,1550.214552219879
2021-02-25,New Jersey Devils,4,Buffalo Sabres,3,1,0,0,1490.0973088535557,1466.5679314798315
2021-02-25,Chicago Blackhawks,2,Columbus Blue Jackets,0,2,0,0,1515.176542520627,1467.491840673761
2021-02-25,Nashville Predators,2,Detroit Red Wings,5,3,0,0,1476.2217757218166,1439.9930679830757
2021-02-25,Dallas Stars,2,Florida Panthers,3,1,1,1,1476.5406011934515,1537.9036342948796
2021-02-25,Boston Bruins,2,New York Islanders,7,5,0,0,1536.543433913624,1510.8967060818386
2021-02-25,Calgary Flames,1,Ottawa Senators,6,5,1,0,1483.539445245984,1456.608862891735
2021-02-25,Carolina Hurricanes,1,Tampa Bay Lightning,3,2,1,1,1532.7517437895933,1553.9207938227953
2021-02-25,Edmonton Oilers,3,Vancouver Canucks,0,3,0,0,1542.8596626460123,1447.751586886905
2021-02-25,Montreal Canadiens,3,Winnipeg Jets,6,3,0,0,1488.8569082094957,1530.168981899989
2021-02-25,Pittsburgh Penguins,2,Washington Capitals,5,3,0,0,1514.5622887606303,1502.4967205981682
2021-02-26,Colorado Avalanche,3,Arizona Coyotes,2,1,0,0,1522.462354436695,1485.4081433792628
2021-02-26,Los Angeles Kings,1,Minnesota Wild,3,2,0,0,1502.4921581662302,1535.7067792897635
2021-02-26,Boston Bruins,2,New York Rangers,6,4,1,0,1529.142420418742,1476.713468262431
2021-02-27,Vegas Golden Knights,3,Anaheim Ducks,2,1,0,0,1542.3679959632973,1438.2605809630018
2021-02-27,Colorado Avalanche,6,Arizona Coyotes,2,4,1,1,1530.1403699289292,1477.7301278870286
2021-02-27,Philadelphia Flyers,3,Buffalo Sabres,0,3,0,0,1517.0670839087963,1459.0240031158378
2021-02-27,Detroit Red Wings,5,Chicago Blackhawks,3,2,0,0,1450.2257064623197,1504.943904041383
2021-02-27,Toronto Maple Leafs,4,Edmonton Oilers,0,4,0,0,1558.573224921719,1534.5009899441723
2021-02-27,Carolina Hurricanes,4,Florida Panthers,3,1,0,0,1541.398361758618,1529.257016325855
2021-02-27,Los Angeles Kings,3,Minnesota Wild,4,1,1,1,1495.7826316858261,1542.4163057701676
2021-02-27,Washington Capitals,5,New Jersey Devils,2,3,0,0,1510.7393347429631,1481.8546947087607
2021-02-27,Columbus Blue Jackets,1,Nashville Predators,2,1,0,0,1460.2208125637355,1483.4928038318421
2021-02-27,Pittsburgh Penguins,4,New York Islanders,3,1,0,0,1523.0058887318198,1502.453106110649
2021-02-27,Calgary Flames,6,Ottawa Senators,3,3,0,0,1491.448584583714,1448.6997235540052
2021-02-27,St. Louis Blues,7,San Jose Sharks,6,1,0,0,1498.4435784065881,1474.8584093951613
2021-02-27,Dallas Stars,0,Tampa Bay Lightning,5,5,0,0,1470.8214588279097,1559.639936188337
2021-02-27,Montreal Canadiens,1,Winnipeg Jets,2,1,0,0,1482.3316959859324,1536.6941941235523
2021-02-28,Philadelphia Flyers,3,Buffalo Sabres,0,3,1,1,1524.2708889360163,1451.8201980886179
2021-02-28,Detroit Red Wings,2,Chicago Blackhawks,7,5,1,1,1444.0033248824295,1511.1662856212731
2021-02-28,Washington Capitals,3,New Jersey Devils,2,1,1,1,1518.6037694131212,1473.9902600386026
2021-02-28,Columbus Blue Jackets,1,Nashville Predators,3,2,1,1,1453.283870006416,1490.4297463891617
2021-02-28,Pittsburgh Penguins,0,New York Islanders,2,2,1,1,1515.0611946750837,1510.3978001673852
2021-02-28,Boston Bruins,4,New York Rangers,1,3,0,0,1536.4722799351168,1469.383608746056
2021-03-01,St. Louis Blues,5,Anaheim Ducks,4,1,0,0,1505.5995094529092,1431.1046499166807
2021-03-01,Toronto Maple Leafs,3,Edmonton Oilers,0,3,0,0,1566.547826469493,1526.5263883963983
2021-03-01,Carolina Hurricanes,3,Florida Panthers,2,1,0,0,1549.6469106940863,1521.0084673903866
2021-03-01,Calgary Flames,1,Ottawa Senators,5,4,0,0,1482.9971930748843,1457.1511150628348
2021-03-01,Colorado Avalanche,2,San Jose Sharks,6,4,0,0,1521.4060903357372,1483.5926889883533
2021-03-01,Minnesota Wild,4,Vegas Golden Knights,5,1,0,0,1534.9431933957633,1549.8411083377016
2021-03-01,Vancouver Canucks,4,Winnipeg Jets,0,4,0,0,1458.2839706711834,1526.1618103392739
2021-03-02,Detroit Red Wings,1,Columbus Blue Jackets,4,3,0,0,1436.7449665218019,1460.5422283670437
2021-03-02,Tampa Bay Lightning,2,Dallas Stars,0,2,0,0,1566.166231418564,1464.2951635976829
2021-03-02,Ottawa Senators,1,Montreal Canadiens,3,2,1,0,1451.8579063139039,1487.6249047348633
2021-03-02,New York Islanders,2,New Jersey Devils,1,1,0,0,1518.0905406132813,1466.2975195927065
2021-03-02,Carolina Hurricanes,4,Nashville Predators,2,2,1,0,1558.4244369421158,1481.6522201411321
2021-03-02,Buffalo Sabres,2,New York Rangers,3,1,0,0,1444.7522664293454,1476.4515404053286
2021-03-02,Philadelphia Flyers,2,Pittsburgh Penguins,5,3,0,0,1516.5868775434471,1522.7452060676528
2021-03-02,Vancouver Canucks,2,Winnipeg Jets,5,3,1,1,1452.3553294709618,1532.0904515394955
2021-03-03,St. Louis Blues,3,Anaheim Ducks,2,1,0,0,1512.4380133875734,1424.2661459820165
2021-03-03,Washington Capitals,2,Boston Bruins,1,1,0,0,1527.542844703224,1527.533204645014
2021-03-03,Toronto Maple Leafs,6,Edmonton Oilers,1,5,0,0,1574.1583531884198,1518.9158616774714
2021-03-03,Arizona Coyotes,3,Los Angeles Kings,2,1,0,0,1486.6734284773777,1486.839331095477
2021-03-03,Colorado Avalanche,4,San Jose Sharks,0,4,0,0,1529.0668262016954,1475.931953122395
2021-03-03,Minnesota Wild,1,Vegas Golden Knights,5,4,0,0,1527.8140204755255,1556.9702812579394
2021-03-04,Detroit Red Wings,2,Carolina Hurricanes,5,3,0,0,1431.9655434547615,1563.2038600091562
2021-03-04,Ottawa Senators,3,Calgary Flames,7,4,0,0,1445.1010011677424,1489.7540982210458
2021-03-04,Tampa Bay Lightning,3,Chicago Blackhawks,2,1,0,0,1573.4382845983507,1503.8942324414863
2021-03-04,Columbus Blue Jackets,3,Dallas Stars,2,1,0,0,1469.1566395334441,1455.6807524312824
2021-03-04,Winnipeg Jets,4,Montreal Canadiens,3,1,0,0,1539.6001481672577,1480.1152081071011
2021-03-04,New York Rangers,6,New Jersey Devils,1,5,0,0,1484.7458019801759,1458.0032580178593
2021-03-04,Florida Panthers,5,Nashville Predators,4,1,0,0,1528.6341125444476,1474.0265749870712
2021-03-04,Buffalo Sabres,2,New York Islanders,5,3,0,0,1438.944301084297,1523.8985059583297
2021-03-04,Philadelphia Flyers,4,Pittsburgh Penguins,3,1,0,0,1525.2566634496175,1514.0754201614825
2021-03-04,Toronto Maple Leafs,1,Vancouver Canucks,3,2,1,0,1565.5912539124258,1460.9224287469558
2021-03-05,Minnesota Wild,5,Arizona Coyotes,1,4,0,0,1535.399126133801,1479.0883228191021
2021-03-05,Washington Capitals,1,Boston Bruins,5,4,0,0,1520.070622732681,1535.005426615557
2021-03-05,Tampa Bay Lightning,3,Chicago Blackhawks,4,1,1,1,1564.3860221710777,1512.9464948687594
2021-03-05,Anaheim Ducks,2,Colorado Avalanche,3,1,0,0,1419.1366521594773,1534.1963200242346
2021-03-05,St. Louis Blues,3,Los Angeles Kings,2,1,0,0,1520.3776462270055,1478.899698256045
2021-03-05,Vegas Golden Knights,5,San Jose Sharks,4,1,0,0,1563.6654232472683,1469.236811133066
2021-03-06,Minnesota Wild,2,Arizona Coyotes,5,3,1,1,1526.6417572037544,1487.8456917491487
2021-03-06,Anaheim Ducks,5,Colorado Avalanche,4,1,1,1,1430.2212137268148,1523.1117584568972
2021-03-06,Columbus Blue Jackets,0,Dallas Stars,5,5,0,0,1461.3745012752886,1463.462890689438
2021-03-06,Calgary Flames,2,Edmonton Oilers,3,1,0,0,1482.952000231728,1525.717959666789
2021-03-06,St. Louis Blues,3,Los Angeles Kings,4,1,1,1,1511.9550927630155,1487.322251720035
2021-03-06,Winnipeg Jets,1,Montreal Canadiens,7,6,0,0,1530.771685134119,1488.9436711402398
2021-03-06,New York Rangers,6,New Jersey Devils,3,3,0,0,1492.6592453316298,1450.0898146664053
2021-03-06,Florida Panthers,6,Nashville Predators,2,4,0,0,1535.9149801190363,1466.7457074124825
2021-03-06,Buffalo Sabres,2,New York Islanders,5,3,0,0,1433.390369004073,1529.4524380385537
2021-03-06,Philadelphia Flyers,3,Pittsburgh Penguins,4,1,0,0,1517.5272946541197,1521.8047889569802
2021-03-06,Vegas Golden Knights,4,San Jose Sharks,0,4,1,1,1570.0711254609678,1462.8311089193667
2021-03-06,Toronto Maple Leafs,2,Vancouver Canucks,4,2,0,0,1555.779523806268,1470.7341588531137
2021-03-07,New Jersey Devils,1,Boston Bruins,0,1,1,0,1462.1350450113523,1522.9601962706101
2021-03-07,Florida Panthers,2,Carolina Hurricanes,4,2,1,0,1530.6700408596332,1568.4487992685592
2021-03-07,Ottawa Senators,4,Calgary Flames,3,1,0,1,1452.8971208369694,1475.1558805625011
2021-03-07,Tampa Bay Lightning,6,Chicago Blackhawks,3,3,0,0,1571.7381624638926,1505.5943545759444
2021-03-07,Nashville Predators,4,Dallas Stars,3,1,1,1,1475.1981200134057,1455.0104780885147
2021-03-07,Buffalo Sabres,2,New York Islanders,5,3,1,1,1428.0755877010965,1534.76721934153
2021-03-07,Washington Capitals,3,Philadelphia Flyers,1,2,0,1,1526.940061485507,1510.6578559012937
2021-03-07,New York Rangers,1,Pittsburgh Penguins,5,4,1,1,1485.856776484264,1528.607257804346
2021-03-08,Los Angeles Kings,5,Anaheim Ducks,6,1,0,0,1478.54716319916,1438.9963022476898
2021-03-08,Arizona Coyotes,3,Colorado Avalanche,2,1,0,0,1497.182945592496,1513.7745046135499
2021-03-08,Ottawa Senators,2,Edmonton Oilers,3,1,1,0,1448.6777530643815,1529.937327439377
2021-03-08,Vegas Golden Knights,0,Minnesota Wild,2,2,0,0,1561.6043032588616,1535.1085794058606
2021-03-08,St. Louis Blues,2,San Jose Sharks,3,1,0,0,1503.3594489314319,1471.4267527509503
2021-03-08,Montreal Canadiens,1,Vancouver Canucks,2,1,0,0,1481.0527651234747,1478.6250648698788
2021-03-09,Nashville Predators,2,Carolina Hurricanes,3,1,0,0,1469.8231811288308,1573.8237381531342
2021-03-09,Florida Panthers,4,Columbus Blue Jackets,2,2,0,0,1537.62327814569,1454.4212639892319
2021-03-09,Chicago Blackhawks,1,Dallas Stars,6,5,0,0,1496.965778257289,1463.63905440717
2021-03-09,Tampa Bay Lightning,4,Detroit Red Wings,3,1,0,0,1577.2108548884748,1426.4928510301793
2021-03-09,Boston Bruins,1,New York Islanders,2,1,0,0,1515.759958415382,1541.9674571967582
2021-03-09,Buffalo Sabres,4,Philadelphia Flyers,5,1,0,0,1422.4700957123844,1516.263347890006
2021-03-09,New York Rangers,2,Pittsburgh Penguins,4,2,0,0,1479.3642047424705,1535.0998295461395
2021-03-09,Winnipeg Jets,4,Toronto Maple Leafs,3,1,0,0,1539.8745195257402,1546.6766894146467
2021-03-09,New Jersey Devils,4,Washington Capitals,5,1,0,0,1456.1381681359792,1532.93693836088
2021-03-10,Los Angeles Kings,5,Anaheim Ducks,1,4,0,0,1486.168384498771,1431.3750809480787
2021-03-10,Arizona Coyotes,1,Colorado Avalanche,2,1,0,0,1490.0926902146414,1520.8647599914045
2021-03-10,Ottawa Senators,1,Edmonton Oilers,7,6,0,0,1443.043437348364,1535.5716431553944
2021-03-10,Vegas Golden Knights,3,Minnesota Wild,4,1,0,0,1553.5233966225203,1543.189486042202
2021-03-10,Montreal Canadiens,5,Vancouver Canucks,1,4,0,0,1489.524866169084,1470.1529638242696
2021-03-11,New York Rangers,0,Boston Bruins,4,4,0,0,1472.7271958608817,1522.3969672969708
2021-03-11,Pittsburgh Penguins,5,Buffalo Sabres,2,3,0,0,1541.1216169563652,1416.4483083021587
2021-03-11,Nashville Predators,1,Carolina Hurricanes,5,4,0,0,1464.6768320779008,1578.9700872040642
2021-03-11,Florida Panthers,5,Columbus Blue Jackets,4,1,0,0,1544.2712823838613,1447.7732597510606
2021-03-11,Montreal Canadiens,1,Calgary Flames,2,1,1,0,1483.3221965553437,1481.3585501762414
2021-03-11,Chicago Blackhawks,4,Dallas Stars,2,2,0,0,1504.7287470035299,1455.8760856609292
2021-03-11,Tampa Bay Lightning,4,Detroit Red Wings,6,2,0,0,1566.4709093138035,1437.2327966048506
2021-03-11,New Jersey Devils,3,New York Islanders,5,2,0,0,1450.6032158322932,1547.5024095004442
2021-03-11,Washington Capitals,5,Philadelphia Flyers,3,2,0,0,1541.0813092169924,1508.1189770338935
2021-03-11,Winnipeg Jets,3,Toronto Maple Leafs,4,1,0,0,1532.559125266773,1553.992083673614
2021-03-12,San Jose Sharks,6,Anaheim Ducks,0,6,0,0,1479.0365924755595,1423.7652412234695
2021-03-12,Los Angeles Kings,0,Colorado Avalanche,2,2,0,0,1479.4926528034014,1527.5404916867742
2021-03-12,Ottawa Senators,2,Edmonton Oilers,6,4,0,0,1437.652997559119,1540.9620829446394
2021-03-12,Arizona Coyotes,0,Minnesota Wild,4,4,0,0,1483.8338590960675,1549.4483171607758
2021-03-12,Vegas Golden Knights,5,St. Louis Blues,4,1,0,0,1560.9042890746227,1495.9785564793294
2021-03-13,San Jose Sharks,3,Anaheim Ducks,1,2,1,1,1486.302551089444,1416.499282609585
2021-03-13,New York Rangers,4,Boston Bruins,0,4,0,0,1482.3911562655821,1512.7330068922704
2021-03-13,Pittsburgh Penguins,3,Buffalo Sabres,0,3,0,0,1546.8960917105026,1410.6738335480213
2021-03-13,Dallas Stars,3,Columbus Blue Jackets,4,1,0,0,1448.217545018427,1455.4318003935628
2021-03-13,Montreal Canadiens,1,Calgary Flames,3,2,0,0,1475.804982407966,1488.875764323619
2021-03-13,Chicago Blackhawks,2,Florida Panthers,4,2,0,0,1498.1633364629765,1550.8366929244146
2021-03-13,New York Islanders,3,New Jersey Devils,2,1,0,0,1553.8553285043363,1444.2502968284011
2021-03-13,Washington Capitals,5,Philadelphia Flyers,4,1,0,0,1548.8525924927785,1500.3476937581074
2021-03-13,Vegas Golden Knights,5,St. Louis Blues,1,4,1,1,1567.954481036303,1488.9283645176492
2021-03-13,Nashville Predators,3,Tampa Bay Lightning,6,3,0,0,1459.4838851806785,1571.6638562110259
2021-03-13,Winnipeg Jets,5,Toronto Maple Leafs,2,3,0,0,1541.5800122977605,1544.9711966426264
2021-03-13,Edmonton Oilers,1,Vancouver Canucks,2,1,1,0,1533.481848116767,1477.633198652142
2021-03-14,Dallas Stars,2,Columbus Blue Jackets,1,1,1,1,1456.9116355176468,1446.737709894343
2021-03-14,Los Angeles Kings,1,Colorado Avalanche,4,3,0,0,1473.1199958240284,1533.9131486661472
2021-03-14,Carolina Hurricanes,2,Detroit Red Wings,1,1,0,0,1584.4042234249453,1431.7986603839695
2021-03-14,Arizona Coyotes,1,Minnesota Wild,4,3,0,0,1477.854978847106,1555.4271974097373
2021-03-14,New York Islanders,3,New Jersey Devils,2,1,1,1,1559.9400971886355,1438.165528144102
2021-03-14,Toronto Maple Leafs,3,Ottawa Senators,4,1,1,0,1536.7038057385817,1445.9203884631638
2021-03-15,Washington Capitals,6,Buffalo Sabres,0,6,0,0,1554.356686716194,1405.1697393246059
2021-03-15,Edmonton Oilers,3,Calgary Flames,4,1,0,0,1524.9883613549648,1497.3692510854212
2021-03-15,Chicago Blackhawks,3,Florida Panthers,6,3,0,0,1491.8949777539926,1557.1050516333985
2021-03-15,Philadelphia Flyers,5,New York Rangers,4,1,0,0,1508.4625969501947,1474.276253073495
2021-03-15,Vancouver Canucks,3,Ottawa Senators,2,1,0,1,1483.8330053929583,1439.7205817223476
2021-03-15,Boston Bruins,1,Pittsburgh Penguins,4,3,0,0,1506.045115528963,1553.58398307381
2021-03-15,Nashville Predators,4,Tampa Bay Lightning,1,3,0,0,1470.5087541927344,1560.63898719897
2021-03-15,San Jose Sharks,1,Vegas Golden Knights,2,1,0,0,1480.6767907579679,1573.580241367779
2021-03-15,Montreal Canadiens,4,Winnipeg Jets,2,2,0,0,1485.8296703602555,1531.555324345471
2021-03-16,Anaheim Ducks,4,Colorado Avalanche,8,4,0,0,1411.6324097487611,1538.780021526971
2021-03-16,Tampa Bay Lightning,4,Dallas Stars,3,1,1,0,1568.44709671554,1449.1035260010767
2021-03-16,Carolina Hurricanes,2,Detroit Red Wings,4,2,0,0,1573.628148200687,1442.5747356082277
2021-03-16,Arizona Coyotes,0,Minnesota Wild,3,3,0,0,1472.140045261838,1561.1421309950053
2021-03-16,Buffalo Sabres,2,New Jersey Devils,3,1,1,0,1400.0552195167604,1443.2800479519474
2021-03-16,Boston Bruins,2,Pittsburgh Penguins,1,1,1,1,1515.6609580516715,1543.9681405511014
2021-03-16,New York Islanders,1,Washington Capitals,3,2,0,1,1550.7395454776452,1563.5572384271843
2021-03-17,Edmonton Oilers,7,Calgary Flames,3,4,0,0,1532.8817440608043,1489.4758683795817
2021-03-17,St. Louis Blues,1,Los Angeles Kings,4,3,0,0,1481.09261436152,1480.9557459801576
2021-03-17,Philadelphia Flyers,0,New York Rangers,9,9,0,0,1500.2059579023103,1482.5328921213793
2021-03-17,Vancouver Canucks,3,Ottawa Senators,2,1,0,0,1491.3507022740432,1432.2028848412626
2021-03-17,San Jose Sharks,4,Vegas Golden Knights,5,1,0,0,1475.294404070444,1578.962628055303
2021-03-17,Montreal Canadiens,3,Winnipeg Jets,4,1,0,0,1479.40450536771,1537.9804893380165
2021-03-18,Arizona Coyotes,2,Anaheim Ducks,3,1,0,0,1463.2887222856305,1420.4837327249686
2021-03-18,Boston Bruins,4,Buffalo Sabres,1,3,0,0,1521.621112514195,1394.095065054237
2021-03-18,Columbus Blue Jackets,3,Carolina Hurricanes,2,1,0,0,1458.0641392944651,1562.301718800565
2021-03-18,Minnesota Wild,1,Colorado Avalanche,5,4,0,0,1553.155934243493,1546.7662182784834
2021-03-18,Dallas Stars,2,Detroit Red Wings,3,1,0,0,1441.4812127389723,1450.197048870332
2021-03-18,Winnipeg Jets,1,Edmonton Oilers,2,1,1,1,1530.3910948168261,1540.4711385819946
2021-03-18,Nashville Predators,2,Florida Panthers,1,1,0,0,1480.9904185806988,1546.623387245434
2021-03-18,Pittsburgh Penguins,2,New Jersey Devils,3,1,0,0,1534.2405080683945,1453.0076804346543
2021-03-18,Philadelphia Flyers,4,New York Islanders,3,1,1,0,1511.48940045455,1539.4561029254055
2021-03-18,Chicago Blackhawks,2,Tampa Bay Lightning,4,2,0,0,1486.1576742106697,1574.184400258863
2021-03-19,Vegas Golden Knights,4,Los Angeles Kings,2,2,0,0,1585.2919475305503,1474.6264265049103
2021-03-19,Vancouver Canucks,3,Montreal Canadiens,2,1,0,0,1499.603739275048,1471.1514683667053
2021-03-19,St. Louis Blues,2,San Jose Sharks,1,1,0,0,1489.4871180287798,1466.8999004031841
2021-03-19,Calgary Flames,4,Toronto Maple Leafs,3,1,0,0,1499.0846829993386,1527.0949911188247
2021-03-19,New York Rangers,1,Washington Capitals,2,1,0,0,1476.8934450845693,1569.1966854639943
2021-03-20,Arizona Coyotes,5,Anaheim Ducks,1,4,0,0,1470.8360577649112,1412.9363972456879
2021-03-20,Columbus Blue Jackets,3,Carolina Hurricanes,2,1,0,0,1468.922785669818,1551.443072425212
2021-03-20,Minnesota Wild,0,Colorado Avalanche,6,6,0,0,1545.5368221818194,1554.385330340157
2021-03-20,Dallas Stars,3,Detroit Red Wings,0,3,0,0,1450.2098601939388,1441.4684014153656
2021-03-20,Winnipeg Jets,2,Edmonton Oilers,4,2,0,0,1523.1511313010453,1547.7111020977754
2021-03-20,Nashville Predators,0,Florida Panthers,2,2,0,0,1475.0119497027313,1552.6018561234016
2021-03-20,Vancouver Canucks,4,Montreal Canadiens,5,1,1,1,1491.4780621329976,1479.2771455087557
2021-03-20,Pittsburgh Penguins,3,New Jersey Devils,1,2,0,0,1540.931407163821,1446.3167813392279
2021-03-20,Philadelphia Flyers,1,New York Islanders,6,5,0,0,1504.659970356045,1546.2855330239104
2021-03-20,St. Louis Blues,5,San Jose Sharks,2,3,1,1,1497.4957595994642,1458.8912588324997
2021-03-20,Chicago Blackhawks,1,Tampa Bay Lightning,4,3,0,0,1480.670279877515,1579.6717945920177
2021-03-20,Calgary Flames,0,Toronto Maple Leafs,2,2,1,1,1492.2562504702612,1533.9234236479022
2021-03-20,New York Rangers,3,Washington Capitals,1,2,1,1,1487.4981751567332,1558.5919553918304
2021-03-21,Nashville Predators,4,Dallas Stars,3,1,1,1,1482.9698286005228,1442.2519812961473
2021-03-21,Vegas Golden Knights,1,Los Angeles Kings,3,2,0,0,1575.3545958015918,1484.5637782338688
2021-03-21,New Jersey Devils,2,Pittsburgh Penguins,1,1,1,1,1456.9710602489197,1530.2771282541291
2021-03-21,Florida Panthers,3,Tampa Bay Lightning,5,2,1,1,1545.7519062776068,1586.5217444378125
2021-03-22,Colorado Avalanche,5,Arizona Coyotes,1,4,0,0,1561.0257820069266,1464.1956060981415
2021-03-22,Carolina Hurricanes,3,Columbus Blue Jackets,0,3,0,0,1558.1059139570195,1462.2599441380105
2021-03-22,Anaheim Ducks,1,Minnesota Wild,2,1,0,0,1408.3775462007277,1550.0956732267796
2021-03-22,Buffalo Sabres,3,New York Rangers,5,2,0,0,1388.7233944693987,1492.8698457415715
2021-03-22,Calgary Flames,1,Ottawa Senators,2,1,0,0,1483.4150787837423,1441.0440565277815
2021-03-22,New York Islanders,2,Philadelphia Flyers,1,1,0,0,1553.8596287616997,1497.0858746182557
2021-03-22,Los Angeles Kings,1,San Jose Sharks,2,1,1,0,1478.10172013366,1465.3533169327086
2021-03-22,Winnipeg Jets,4,Vancouver Canucks,0,4,0,0,1530.9518455404045,1483.6773478936384
2021-03-22,St. Louis Blues,1,Vegas Golden Knights,5,4,0,1,1490.1871061325112,1582.6632492685449
2021-03-23,Colorado Avalanche,4,Arizona Coyotes,5,1,1,1,1551.3801728073925,1473.8412152976757
2021-03-23,Florida Panthers,2,Chicago Blackhawks,3,1,0,0,1536.7986314293564,1489.6235547257654
2021-03-23,Tampa Bay Lightning,2,Dallas Stars,1,1,0,0,1591.9064299288545,1436.8672958051052
2021-03-23,Detroit Red Wings,0,Nashville Predators,2,2,0,0,1434.9474878713636,1489.4907421445248
2021-03-23,New Jersey Devils,4,Philadelphia Flyers,3,1,0,1,1464.8186552545378,1489.2382796126376
2021-03-24,Anaheim Ducks,2,Minnesota Wild,3,1,0,0,1403.9990347098021,1554.4741847177052
2021-03-24,Calgary Flames,1,Ottawa Senators,3,2,0,0,1474.9722580787154,1449.4868772328084
2021-03-24,Buffalo Sabres,2,Pittsburgh Penguins,5,3,0,0,1384.3416630956528,1534.658859627875
2021-03-24,Los Angeles Kings,2,San Jose Sharks,4,2,0,0,1470.3363089697016,1473.118728096667
2021-03-24,Winnipeg Jets,5,Vancouver Canucks,1,4,0,0,1538.3979784177955,1476.2312150162475
2021-03-25,New York Islanders,4,Boston Bruins,3,1,0,0,1561.6474326288026,1513.833308647092
2021-03-25,Carolina Hurricanes,4,Columbus Blue Jackets,3,1,0,0,1564.4813100944766,1455.8845480005534
2021-03-25,Florida Panthers,0,Chicago Blackhawks,3,3,0,0,1528.2470117794783,1498.1751743756436
2021-03-25,Vegas Golden Knights,1,Colorado Avalanche,5,4,0,0,1574.4728701101574,1559.57055196578
2021-03-25,Tampa Bay Lightning,3,Dallas Stars,4,1,0,0,1581.0840127557597,1447.6897129782
2021-03-25,St. Louis Blues,0,Minnesota Wild,2,2,0,1,1482.5787056179136,1562.0825852323028
2021-03-25,Detroit Red Wings,1,Nashville Predators,7,6,0,0,1428.721176049345,1495.7170539665433
2021-03-25,Toronto Maple Leafs,3,Ottawa Senators,2,1,0,1,1538.944594077295,1444.4657068034155
2021-03-25,New York Rangers,8,Philadelphia Flyers,3,5,0,0,1501.3142288863946,1480.7938964678144
2021-03-25,Buffalo Sabres,0,Pittsburgh Penguins,4,4,1,1,1380.129916119899,1538.8706066036289
2021-03-25,New Jersey Devils,3,Washington Capitals,4,1,0,0,1459.4549188507178,1563.9556917956504
2021-03-26,San Jose Sharks,2,Arizona Coyotes,5,3,0,0,1465.663363955277,1481.2965794390657
2021-03-26,Winnipeg Jets,3,Calgary Flames,2,1,0,0,1545.4815572574037,1467.8886792391072
2021-03-26,Anaheim Ducks,4,St. Louis Blues,1,3,0,1,1412.7061654414592,1473.8715748862564
2021-03-26,New Jersey Devils,0,Washington Capitals,4,4,1,1,1454.319109898551,1569.0915007478172
2021-03-27,San Jose Sharks,0,Arizona Coyotes,4,4,1,1,1458.5510893057574,1488.4088540885853
2021-03-27,Buffalo Sabres,2,Boston Bruins,3,1,0,0,1375.593068705996,1518.370156060995
2021-03-27,Tampa Bay Lightning,3,Carolina Hurricanes,4,1,0,0,1573.230012126471,1572.3353107237654
2021-03-27,Winnipeg Jets,2,Calgary Flames,4,2,1,1,1536.2520380943045,1477.1181984022064
2021-03-27,Nashville Predators,3,Chicago Blackhawks,1,2,0,0,1504.3016533362716,1489.5905750059153
2021-03-27,Vegas Golden Knights,3,Colorado Avalanche,2,1,0,0,1582.6579418291565,1551.3854802467808
2021-03-27,Florida Panthers,4,Dallas Stars,3,1,0,0,1534.9526518153766,1440.9840729423017
2021-03-27,Columbus Blue Jackets,1,Detroit Red Wings,3,2,0,0,1447.7883595130281,1436.8173645368704
2021-03-27,New York Rangers,1,Philadelphia Flyers,2,1,0,0,1493.3702794186574,1488.7378459355516
2021-03-27,New York Islanders,3,Pittsburgh Penguins,6,3,0,0,1553.651726859614,1546.8663123728174
2021-03-27,Edmonton Oilers,3,Toronto Maple Leafs,4,1,0,0,1540.0372886176735,1546.618407557397
2021-03-28,New Jersey Devils,1,Boston Bruins,0,1,0,1,1462.7054557924537,1509.9838101670923
2021-03-28,Nashville Predators,3,Chicago Blackhawks,2,1,1,1,1512.4911205266435,1481.4011078155434
2021-03-28,Florida Panthers,4,Dallas Stars,1,3,1,1,1541.3682046576018,1434.5685201000765
2021-03-28,Columbus Blue Jackets,1,Detroit Red Wings,4,3,1,1,1440.0638269468943,1444.5418971030042
2021-03-28,Anaheim Ducks,3,St. Louis Blues,2,1,0,0,1422.6281791689928,1463.9495611587229
2021-03-28,New York Rangers,4,Washington Capitals,5,1,1,0,1489.2147338855286,1573.247046280946
2021-03-29,Philadelphia Flyers,4,Buffalo Sabres,3,1,0,0,1494.7489429050074,1369.5819717365403
2021-03-29,Winnipeg Jets,5,Calgary Flames,1,4,0,0,1543.4314283638184,1469.9388081326924
2021-03-29,Anaheim Ducks,2,Colorado Avalanche,5,3,1,0,1419.5922636427035,1554.4213957730701
2021-03-29,New York Islanders,1,Pittsburgh Penguins,2,1,0,0,1546.0235067784915,1554.4945324539399
2021-03-29,Minnesota Wild,3,San Jose Sharks,4,1,0,0,1552.294825935393,1468.3388486026672
2021-03-29,Edmonton Oilers,3,Toronto Maple Leafs,2,1,0,0,1548.716806360308,1537.9388898147624
2021-03-29,Los Angeles Kings,1,Vegas Golden Knights,4,3,0,0,1465.3641217451468,1587.6301290537112
2021-03-30,New Jersey Devils,4,Boston Bruins,5,1,0,0,1456.315410095311,1516.3738558642349
2021-03-30,Carolina Hurricanes,1,Chicago Blackhawks,2,1,0,0,1562.8160095776918,1490.9204089616169
2021-03-30,Detroit Red Wings,1,Florida Panthers,4,3,0,0,1439.2434238055828,1546.6666779550233
2021-03-30,Edmonton Oilers,0,Montreal Canadiens,4,4,1,0,1541.2668539782858,1486.727097890778
2021-03-30,Dallas Stars,2,Nashville Predators,3,1,0,0,1428.861263469515,1518.198377157205
2021-03-30,Washington Capitals,2,New York Rangers,5,3,0,0,1563.876998172848,1498.5847819936266
2021-03-30,Columbus Blue Jackets,3,Tampa Bay Lightning,1,2,0,0,1451.5162689041779,1561.7775701691874
2021-03-31,Philadelphia Flyers,1,Buffalo Sabres,6,5,0,0,1484.5134021811941,1379.8175124603536
2021-03-31,Arizona Coyotes,3,Colorado Avalanche,9,6,0,0,1482.4388188580697,1560.3914310035857
2021-03-31,Minnesota Wild,2,San Jose Sharks,4,2,0,0,1542.9264366529874,1477.7072378850728
2021-03-31,Los Angeles Kings,4,Vegas Golden Knights,2,2,0,0,1476.5966674621131,1576.397583336745
2021-03-31,Toronto Maple Leafs,3,Winnipeg Jets,1,2,0,0,1546.5933496539299,1534.776968524651
2021-04-01,Pittsburgh Penguins,4,Boston Bruins,1,3,0,0,1562.1482768688447,1508.72011144933
2021-04-01,New York Rangers,3,Buffalo Sabres,2,1,0,1,1502.8798316371897,1375.5224628167905
2021-04-01,Carolina Hurricanes,4,Chicago Blackhawks,3,1,0,0,1569.7117837624958,1484.024634776813
2021-04-01,Detroit Red Wings,2,Florida Panthers,3,1,0,0,1434.1690166194826,1551.7410851411234
2021-04-01,Dallas Stars,4,Nashville Predators,1,3,0,0,1439.402158443499,1507.657482183221
2021-04-01,Washington Capitals,4,New York Islanders,8,4,0,0,1555.994267798595,1553.9062371527446
2021-04-01,Montreal Canadiens,4,Ottawa Senators,1,3,0,0,1494.286764457127,1436.9060402370665
2021-04-01,Columbus Blue Jackets,2,Tampa Bay Lightning,3,1,0,0,1446.5011940278248,1566.7926450455404
2021-04-01,Minnesota Wild,3,Vegas Golden Knights,2,1,1,1,1552.2227628232718,1567.1012571664605
2021-04-02,Arizona Coyotes,4,Anaheim Ducks,2,2,0,0,1489.5353026033993,1412.495779897374
2021-04-02,St. Louis Blues,2,Colorado Avalanche,3,1,0,0,1458.6428868126486,1565.69810534966
2021-04-02,Calgary Flames,2,Edmonton Oilers,3,1,0,0,1464.0865053581863,1547.119156752792
2021-04-02,San Jose Sharks,3,Los Angeles Kings,0,3,0,0,1486.2096661431594,1468.0942392040265
2021-04-02,Washington Capitals,2,New Jersey Devils,1,1,1,0,1563.8880438662436,1448.4216340276625
2021-04-02,Toronto Maple Leafs,2,Winnipeg Jets,1,1,0,0,1554.8493722807546,1526.5209458978263
2021-04-03,Pittsburgh Penguins,5,Boston Bruins,7,2,0,0,1553.4556544660402,1517.4127338521346
2021-04-03,New York Rangers,2,Buffalo Sabres,3,1,0,0,1492.5999707824215,1385.8023236715587
2021-04-03,Dallas Stars,3,Carolina Hurricanes,2,1,0,0,1450.7974447015085,1558.3164975044863
2021-04-03,St. Louis Blues,1,Colorado Avalanche,2,1,1,1,1453.560764007621,1570.7802281546876
2021-04-03,Columbus Blue Jackets,2,Florida Panthers,5,3,0,0,1441.3809428814168,1556.8613362875315
2021-04-03,San Jose Sharks,3,Los Angeles Kings,2,1,1,1,1494.3209206121137,1459.9829847350723
2021-04-03,Ottawa Senators,6,Montreal Canadiens,3,3,0,0,1446.74339708243,1484.4494076117635
2021-04-03,Chicago Blackhawks,0,Nashville Predators,3,3,0,0,1477.0959634934743,1514.5861534665596
2021-04-03,Philadelphia Flyers,2,New York Islanders,3,1,0,0,1478.6183182777668,1559.801321056172
2021-04-03,Detroit Red Wings,1,Tampa Bay Lightning,2,1,0,0,1429.6106289975028,1571.3510326675203
2021-04-03,Minnesota Wild,2,Vegas Golden Knights,1,1,0,0,1561.0931435473526,1558.2308764423797
2021-04-04,Arizona Coyotes,3,Anaheim Ducks,2,1,0,0,1496.3179142013032,1405.71316829947
2021-04-04,Dallas Stars,0,Carolina Hurricanes,1,1,1,1,1445.7250450669214,1563.3888971390734
2021-04-04,Toronto Maple Leafs,4,Calgary Flames,2,2,0,0,1561.3337583832079,1457.602119255733
2021-04-04,Columbus Blue Jackets,0,Florida Panthers,3,3,1,1,1436.474199299851,1561.7680798690972
2021-04-04,Washington Capitals,5,New Jersey Devils,4,1,0,0,1569.8510763284266,1442.4586015654795
2021-04-04,Detroit Red Wings,5,Tampa Bay Lightning,1,4,1,1,1441.2325537367174,1559.7291079283057
2021-04-05,Philadelphia Flyers,3,Boston Bruins,2,1,0,0,1488.0358987398517,1507.9951533900496
2021-04-05,Toronto Maple Leafs,5,Calgary Flames,3,2,1,1,1567.54177747975,1451.3941001591909
2021-04-05,Arizona Coyotes,5,Los Angeles Kings,2,3,1,0,1505.6123083800699,1450.6885905563056
2021-04-05,Colorado Avalanche,5,Minnesota Wild,4,1,0,0,1579.0852325702438,1552.7881391317965
2021-04-05,Edmonton Oilers,2,Montreal Canadiens,3,1,0,0,1538.219581612641,1493.3489827519145
2021-04-05,Vegas Golden Knights,6,St. Louis Blues,1,5,0,0,1564.419119231123,1447.3725212188776
2021-04-05,Ottawa Senators,3,Winnipeg Jets,4,1,0,0,1441.076725625267,1532.1876173549892
2021-04-06,Florida Panthers,2,Carolina Hurricanes,5,3,0,0,1554.3334002952054,1570.8235767129652
2021-04-06,Tampa Bay Lightning,2,Columbus Blue Jackets,4,2,0,0,1549.5324137786076,1446.670893449549
2021-04-06,Dallas Stars,2,Chicago Blackhawks,4,2,0,0,1438.9734305060463,1483.8475780543495
2021-04-06,Nashville Predators,3,Detroit Red Wings,2,1,0,0,1521.4497811987683,1434.3689260045087
2021-04-06,Buffalo Sabres,5,New Jersey Devils,3,2,0,0,1395.6234408513144,1432.6374843857238
2021-04-06,Washington Capitals,0,New York Islanders,1,1,0,0,1562.147736677577,1567.5046607070215
2021-04-06,Pittsburgh Penguins,4,New York Rangers,8,4,0,0,1544.5965569657458,1501.4590682827159
2021-04-06,Boston Bruins,4,Philadelphia Flyers,2,2,1,1,1516.064079468392,1479.9669726615093
2021-04-06,Anaheim Ducks,5,San Jose Sharks,1,4,0,0,1416.238324030836,1483.7957648807476
2021-04-07,Arizona Coyotes,3,Los Angeles Kings,4,1,0,0,1496.8860735721487,1459.4148253642268
2021-04-07,Colorado Avalanche,3,Minnesota Wild,8,5,0,0,1571.0088732694405,1560.8644984325997
2021-04-07,Edmonton Oilers,4,Ottawa Senators,2,2,0,0,1544.5673058147534,1434.7290014231546
2021-04-07,Vegas Golden Knights,1,St. Louis Blues,3,2,0,0,1554.349554590622,1457.4420858593787
2021-04-07,Montreal Canadiens,2,Toronto Maple Leafs,3,1,0,0,1487.5598325053713,1573.330927726293
2021-04-08,New Jersey Devils,6,Buffalo Sabres,3,3,0,0,1440.316414339808,1387.9445108972302
2021-04-08,Florida Panthers,0,Carolina Hurricanes,3,3,0,0,1547.2408157797859,1577.9161612283847
2021-04-08,Tampa Bay Lightning,6,Columbus Blue Jackets,4,2,0,0,1555.7587964646964,1440.4445107634604
2021-04-08,Dallas Stars,5,Chicago Blackhawks,1,4,0,0,1448.5289884318634,1474.2920201285324
2021-04-08,Nashville Predators,7,Detroit Red Wings,1,6,0,0,1528.0136284327607,1427.8050787705163
2021-04-08,Winnipeg Jets,4,Montreal Canadiens,2,2,0,1,1538.0936390585232,1481.6538108018374
2021-04-08,Philadelphia Flyers,2,New York Islanders,3,1,0,0,1474.469007117602,1573.0026262509289
2021-04-08,Pittsburgh Penguins,5,New York Rangers,2,3,0,0,1552.1363523015004,1493.9192729469612
2021-04-08,Edmonton Oilers,3,Ottawa Senators,1,2,1,1,1550.647205185211,1428.649102052697
2021-04-08,Boston Bruins,4,Washington Capitals,2,2,0,0,1525.647015560112,1552.564800585857
2021-04-09,Colorado Avalanche,2,Anaheim Ducks,0,2,0,0,1576.191557428912,1411.0556398713647
2021-04-09,Washington Capitals,4,Buffalo Sabres,3,1,1,1,1557.5625859384925,1382.9467255445948
2021-04-09,Pittsburgh Penguins,6,New Jersey Devils,4,2,1,1,1558.174968224971,1434.2777984163374
2021-04-09,New York Rangers,4,New York Islanders,1,3,1,1,1504.237424234822,1562.6844749630682
2021-04-09,Los Angeles Kings,2,San Jose Sharks,5,3,0,0,1452.5032975507538,1490.7072926942205
2021-04-09,Minnesota Wild,1,St. Louis Blues,9,8,0,0,1551.0790406162605,1467.227543675718
2021-04-09,Arizona Coyotes,4,Vegas Golden Knights,7,3,0,0,1490.7252848456235,1560.510343317147
2021-04-10,Detroit Red Wings,5,Carolina Hurricanes,4,1,0,0,1439.5893731035246,1566.1318668953763
2021-04-10,Chicago Blackhawks,4,Columbus Blue Jackets,3,1,0,0,1482.0431087181569,1432.6934221738359
2021-04-10,Edmonton Oilers,0,Calgary Flames,5,5,0,0,1540.9500230389035,1461.0912823054985
2021-04-10,Florida Panthers,1,Dallas Stars,4,3,0,0,1537.5551377443599,1458.2146664672894
2021-04-10,Winnipeg Jets,5,Montreal Canadiens,0,5,0,0,1545.3333760868438,1474.4140737735167
2021-04-10,Tampa Bay Lightning,3,Nashville Predators,0,3,0,0,1563.6492949318274,1520.1231299656297
2021-04-10,Boston Bruins,2,Philadelphia Flyers,3,1,0,0,1517.0050481062403,1483.1109745714737
2021-04-10,Los Angeles Kings,4,San Jose Sharks,2,2,1,1,1461.9074486551963,1481.303141589778
2021-04-10,Minnesota Wild,2,St. Louis Blues,3,1,1,1,1541.7129220615284,1476.59366223045
2021-04-10,Ottawa Senators,5,Toronto Maple Leafs,6,1,0,0,1424.328436124075,1577.651593654915
2021-04-11,Colorado Avalanche,4,Anaheim Ducks,1,3,0,0,1581.1797882034768,1406.0674090967998
2021-04-11,Washington Capitals,8,Boston Bruins,1,7,0,1,1563.5609330251918,1511.006701019541
2021-04-11,Pittsburgh Penguins,5,New Jersey Devils,2,3,0,0,1563.9652091747573,1428.4875574665512
2021-04-11,Dallas Stars,2,Nashville Predators,3,1,1,1,1452.1532639355755,1526.1845324973435
2021-04-11,New York Rangers,2,New York Islanders,3,1,0,0,1498.0986643618787,1568.8232348360114
2021-04-11,Buffalo Sabres,5,Philadelphia Flyers,3,2,0,1,1392.1192502711833,1473.938449844885
2021-04-11,Arizona Coyotes,0,Vegas Golden Knights,1,1,0,0,1484.838879384656,1566.3967487781147
2021-04-12,Detroit Red Wings,3,Carolina Hurricanes,1,2,0,0,1450.908768658204,1554.812471340697
2021-04-12,Chicago Blackhawks,4,Columbus Blue Jackets,3,1,0,0,1489.4423708803524,1425.2941600116403
2021-04-12,Arizona Coyotes,2,Colorado Avalanche,4,2,1,1,1479.5300504639831,1586.4886171241496
2021-04-12,Vegas Golden Knights,4,Los Angeles Kings,2,2,1,0,1574.1887993760988,1454.1153980572121
2021-04-12,Toronto Maple Leafs,2,Montreal Canadiens,4,2,0,0,1567.870037726767,1484.1956297016648
2021-04-12,Winnipeg Jets,2,Ottawa Senators,4,2,0,0,1535.1825803433155,1434.4792318676034
2021-04-12,Anaheim Ducks,4,San Jose Sharks,0,4,1,0,1417.9011961904093,1469.4693544961685
2021-04-13,Buffalo Sabres,2,Boston Bruins,3,1,0,0,1387.2826678724473,1515.843283418277
2021-04-13,Florida Panthers,3,Dallas Stars,2,1,0,0,1544.155357416275,1445.5530442636605
2021-04-13,New York Rangers,3,New Jersey Devils,0,3,0,0,1505.0449182441375,1421.5413035842923
2021-04-13,Tampa Bay Lightning,2,Nashville Predators,7,5,0,0,1555.3179650218588,1534.5158624073122
2021-04-13,Calgary Flames,3,Toronto Maple Leafs,2,1,0,1,1470.4033604237786,1558.5579596084867
2021-04-13,Philadelphia Flyers,1,Washington Capitals,6,5,0,0,1468.4854984286656,1569.0138844414114
2021-04-14,Vegas Golden Knights,6,Los Angeles Kings,2,4,0,0,1580.0570651662213,1448.2471322670897
2021-04-14,Arizona Coyotes,2,Minnesota Wild,5,3,0,0,1473.4747691144962,1547.7682034110153
2021-04-14,Calgary Flames,4,Montreal Canadiens,1,3,1,0,1480.8487724433628,1473.7502176820806
2021-04-14,Winnipeg Jets,3,Ottawa Senators,2,1,0,0,1541.4546245111258,1428.2071876997932
2021-04-14,Anaheim Ducks,4,San Jose Sharks,1,3,0,0,1427.6079535909932,1459.7625970955846
2021-04-14,Colorado Avalanche,4,St. Louis Blues,3,1,0,0,1592.5673342788662,1470.5149450757335
2021-04-15,New York Islanders,1,Boston Bruins,4,3,0,0,1560.1406946596476,1524.5258235946408
2021-04-15,Nashville Predators,1,Carolina Hurricanes,4,3,0,0,1527.5106781853885,1561.8176555626205
2021-04-15,Columbus Blue Jackets,1,Dallas Stars,4,3,0,0,1418.2881100990337,1452.559094176267
2021-04-15,Chicago Blackhawks,1,Detroit Red Wings,4,3,0,0,1481.0867221049011,1459.2644174336554
2021-04-15,New Jersey Devils,0,New York Rangers,4,4,0,0,1415.9558591002715,1510.6303627281584
2021-04-15,Philadelphia Flyers,2,Pittsburgh Penguins,1,1,0,0,1479.1582772414145,1553.2924303620084
2021-04-15,Florida Panthers,2,Tampa Bay Lightning,3,1,0,0,1536.9402975526973,1562.5330248854364
2021-04-15,Winnipeg Jets,5,Toronto Maple Leafs,2,3,1,0,1551.9761255455364,1548.036458574076
2021-04-15,Buffalo Sabres,5,Washington Capitals,2,3,0,0,1399.6511616913645,1556.6453906224942
2021-04-16,Vegas Golden Knights,4,Anaheim Ducks,0,4,0,0,1585.2839784351445,1422.38104032207
2021-04-16,New York Islanders,0,Boston Bruins,3,3,1,1,1551.8514922930287,1532.8150259612596
2021-04-16,San Jose Sharks,2,Minnesota Wild,3,1,0,0,1454.274746383378,1553.256054123222
2021-04-16,Calgary Flames,1,Montreal Canadiens,2,1,0,0,1473.2133449192281,1481.3856452062153
2021-04-17,St. Louis Blues,2,Arizona Coyotes,3,1,0,0,1463.1110958941697,1480.87861829606
2021-04-17,Pittsburgh Penguins,3,Buffalo Sabres,2,1,0,0,1558.4965994310132,1394.4469926223596
2021-04-17,Nashville Predators,1,Carolina Hurricanes,3,2,0,0,1520.826068108051,1568.502265639958
2021-04-17,Columbus Blue Jackets,1,Dallas Stars,5,4,0,0,1411.6026792655196,1459.2445250097812
2021-04-17,Chicago Blackhawks,4,Detroit Red Wings,0,4,0,0,1489.112904695544,1451.2382348430124
2021-04-17,San Jose Sharks,2,Minnesota Wild,5,3,1,1,1449.0221530960769,1558.508647410523
2021-04-17,Ottawa Senators,4,Montreal Canadiens,0,4,0,1,1436.3501936042712,1473.2426393017372
2021-04-17,New Jersey Devils,3,New York Rangers,6,3,0,0,1410.6114192924276,1515.9748025360022
2021-04-17,Washington Capitals,6,Philadelphia Flyers,3,3,0,0,1563.4181893976406,1472.385478466268
2021-04-17,Florida Panthers,5,Tampa Bay Lightning,3,2,0,0,1546.056528336758,1553.4167941013757
2021-04-17,Edmonton Oilers,3,Winnipeg Jets,0,3,0,0,1549.7318232320704,1543.1943253523696
2021-04-18,Vegas Golden Knights,5,Anaheim Ducks,2,3,0,0,1590.3136765033928,1417.3513422538217
2021-04-18,Washington Capitals,3,Boston Bruins,6,3,1,0,1556.8433422849405,1539.3898730739597
2021-04-18,Pittsburgh Penguins,2,Buffalo Sabres,4,2,1,1,1547.5049741294067,1405.4386179239661
2021-04-18,New York Rangers,5,New Jersey Devils,3,2,1,1,1522.148456171809,1404.437765656621
2021-04-18,New York Islanders,1,Philadelphia Flyers,0,1,0,1,1556.9809731799326,1467.2559975793642
2021-04-18,Toronto Maple Leafs,2,Vancouver Canucks,3,1,0,0,1538.934226804741,1485.3334467855825
2021-04-19,Minnesota Wild,5,Arizona Coyotes,2,3,0,0,1565.2783141173943,1474.1089515891888
2021-04-19,Ottawa Senators,4,Calgary Flames,2,2,0,0,1445.723828207484,1463.8397103160153
2021-04-19,Detroit Red Wings,2,Dallas Stars,3,1,0,0,1443.9505538621154,1466.5322059906782
2021-04-19,Montreal Canadiens,1,Edmonton Oilers,4,3,0,0,1467.5039547073043,1555.4705078265033
2021-04-19,Columbus Blue Jackets,2,Florida Panthers,4,2,0,0,1407.0807738183848,1550.5784337838927
2021-04-19,Chicago Blackhawks,2,Nashville Predators,5,3,0,0,1482.3691060206122,1527.569866782983
2021-04-19,Carolina Hurricanes,2,Tampa Bay Lightning,3,1,0,0,1560.6831279409232,1561.2359318004105
2021-04-19,San Jose Sharks,2,Vegas Golden Knights,3,1,0,1,1443.0352835113533,1596.3005460881163
2021-04-20,Boston Bruins,2,Buffalo Sabres,0,2,0,0,1544.9777827931346,1399.8507082047913
2021-04-20,Detroit Red Wings,2,Dallas Stars,5,3,1,1,1436.997784681093,1473.4849751717006
2021-04-20,Columbus Blue Jackets,1,Florida Panthers,5,4,1,1,1402.7370415295272,1554.9221660727503
2021-04-20,Anaheim Ducks,1,Los Angeles Kings,4,3,0,0,1410.5888748380512,1455.0095996828602
2021-04-20,New York Rangers,1,New York Islanders,6,5,0,0,1515.4758280735011,1563.6536012782403
2021-04-20,New Jersey Devils,6,Pittsburgh Penguins,7,1,0,0,1400.085633331855,1551.8571064541727
2021-04-20,Carolina Hurricanes,4,Tampa Bay Lightning,1,3,1,1,1569.223856709444,1552.6952030318898
2021-04-20,Toronto Maple Leafs,3,Vancouver Canucks,6,3,0,0,1530.2377226270553,1494.0299509632682
2021-04-21,Minnesota Wild,4,Arizona Coyotes,1,3,0,0,1571.7539537170037,1467.6333119895794
2021-04-21,Nashville Predators,4,Chicago Blackhawks,5,1,0,0,1519.0629132795323,1490.8760595240628
2021-04-21,Montreal Canadiens,4,Edmonton Oilers,3,1,0,0,1478.0152600532533,1544.9592024805543
2021-04-21,San Jose Sharks,2,Vegas Golden Knights,5,3,0,0,1438.8799479055995,1600.4558816938702
2021-04-22,Boston Bruins,5,Buffalo Sabres,1,4,0,0,1550.3457917051176,1394.4826992928083
2021-04-22,Dallas Stars,3,Detroit Red Wings,7,4,0,0,1465.1759016361557,1445.306858216638
2021-04-22,Carolina Hurricanes,4,Florida Panthers,2,2,0,0,1577.422733984691,1546.7232887975033
2021-04-22,Washington Capitals,1,New York Islanders,0,1,0,0,1565.5281342130245,1554.9688093501563
2021-04-22,Philadelphia Flyers,3,New York Rangers,2,1,0,0,1476.8872258044423,1505.844599848423
2021-04-22,New Jersey Devils,1,Pittsburgh Penguins,5,4,0,0,1395.901763180862,1556.0409766051657
2021-04-22,Colorado Avalanche,4,St. Louis Blues,2,2,0,0,1598.2451888362664,1457.4332413367695
2021-04-22,Columbus Blue Jackets,1,Tampa Bay Lightning,3,2,0,0,1398.5183975791642,1556.9138469822528
2021-04-22,Ottawa Senators,3,Vancouver Canucks,0,3,0,0,1455.3570055318748,1484.3967736388774
2021-04-22,Toronto Maple Leafs,5,Winnipeg Jets,3,2,0,0,1539.0639212077847,1534.3681267716402
2021-04-23,Boston Bruins,4,Buffalo Sabres,6,2,1,1,1539.5077454017792,1405.3207455961467
2021-04-23,Montreal Canadiens,2,Calgary Flames,4,2,0,0,1470.2170369572812,1471.6379334119874
2021-04-23,Nashville Predators,3,Chicago Blackhawks,1,2,0,0,1526.9433071681296,1482.9956656354655
2021-04-23,Minnesota Wild,4,Los Angeles Kings,2,2,0,0,1577.6906165459322,1449.0729368539317
2021-04-23,Philadelphia Flyers,1,New York Rangers,4,3,1,1,1470.0804543455079,1512.6513713073575
2021-04-24,Vegas Golden Knights,5,Anaheim Ducks,1,4,0,0,1605.0008554426033,1406.043901089318
2021-04-24,Montreal Canadiens,2,Calgary Flames,5,3,1,1,1462.7777541248317,1479.0772162444368
2021-04-24,Dallas Stars,2,Detroit Red Wings,1,1,0,0,1473.2468980955634,1437.2358617572302
2021-04-24,Carolina Hurricanes,3,Florida Panthers,4,1,0,0,1569.2456870683895,1554.9003357138047
2021-04-24,Arizona Coyotes,4,Los Angeles Kings,0,4,0,1,1474.1343496375844,1442.5718992059267
2021-04-24,Washington Capitals,6,New York Islanders,3,3,0,0,1573.8130716059327,1546.6838719572481
2021-04-24,New Jersey Devils,2,Pittsburgh Penguins,4,2,0,0,1391.876418161975,1560.0663216240528
2021-04-24,Minnesota Wild,6,San Jose Sharks,3,3,1,0,1584.7822479621213,1431.7883164894104
2021-04-24,Colorado Avalanche,3,St. Louis Blues,5,2,0,0,1587.6974638117474,1467.9809663612884
2021-04-24,Ottawa Senators,2,Vancouver Canucks,4,2,0,0,1448.5521181109912,1491.2016610597611
2021-04-24,Toronto Maple Leafs,4,Winnipeg Jets,1,3,0,0,1547.4838031283653,1525.9482448510596
2021-04-25,Buffalo Sabres,3,New York Rangers,6,3,0,0,1400.2443969778642,1517.72771992564
2021-04-25,New Jersey Devils,3,Philadelphia Flyers,4,1,1,0,1387.775325387136,1474.1815471203467
2021-04-25,Boston Bruins,0,Pittsburgh Penguins,1,1,0,1,1530.9085723952385,1568.6654946305935
2021-04-25,Columbus Blue Jackets,3,Tampa Bay Lightning,4,1,0,0,1394.460283119653,1560.971961441764
2021-04-26,Montreal Canadiens,2,Calgary Flames,1,1,0,0,1471.6807880143303,1470.1741823549382
2021-04-26,Carolina Hurricanes,3,Dallas Stars,4,1,0,0,1559.6178195674188,1482.8747655965342
2021-04-26,Anaheim Ducks,1,Los Angeles Kings,4,3,0,0,1399.4099039563828,1449.205896338862
2021-04-26,Florida Panthers,1,Nashville Predators,4,3,0,0,1546.7859871260894,1535.057655755845
2021-04-26,Vancouver Canucks,1,Ottawa Senators,2,1,0,0,1482.7525222380918,1457.0012569326605
2021-04-26,Arizona Coyotes,4,San Jose Sharks,6,2,0,0,1465.6920958594426,1440.2305702675521
2021-04-26,Colorado Avalanche,1,St. Louis Blues,4,3,0,0,1577.5730417404695,1478.1053884325663
2021-04-26,Edmonton Oilers,6,Winnipeg Jets,1,5,0,0,1553.0498953571937,1517.8575519744202
2021-04-27,Detroit Red Wings,0,Columbus Blue Jackets,1,1,0,0,1428.7838642787697,1402.9122805981135
2021-04-27,Tampa Bay Lightning,7,Chicago Blackhawks,4,3,0,0,1567.7340418944918,1476.2335851827377
2021-04-27,Carolina Hurricanes,5,Dallas Stars,1,4,1,1,1566.4069338825318,1476.0856512814212
2021-04-27,Philadelphia Flyers,4,New Jersey Devils,6,2,0,0,1464.7599989237399,1397.196873583743
2021-04-27,Florida Panthers,7,Nashville Predators,4,3,1,1,1555.044034847636,1526.7996080342982
2021-04-27,Buffalo Sabres,1,New York Rangers,3,2,0,0,1395.378953734594,1522.5931631689102
2021-04-27,Boston Bruins,3,Pittsburgh Penguins,1,2,0,0,1540.3025513106522,1559.2715157151797
2021-04-27,New York Islanders,0,Washington Capitals,1,1,0,0,1539.8352783824962,1580.6616651806846
2021-04-28,Anaheim Ducks,3,Los Angeles Kings,2,1,0,0,1409.0767119593088,1439.539088335936
2021-04-28,St. Louis Blues,4,Minnesota Wild,3,1,0,0,1489.0153284935454,1573.8723079011422
2021-04-28,Toronto Maple Leafs,4,Montreal Canadiens,1,3,0,0,1554.293552081076,1464.8710390616195
2021-04-28,Vancouver Canucks,3,Ottawa Senators,6,3,0,0,1474.6886608406153,1465.065118330137
2021-04-28,Arizona Coyotes,2,San Jose Sharks,4,2,0,0,1457.6348698572158,1448.287796269779
2021-04-28,Colorado Avalanche,2,Vegas Golden Knights,5,3,0,0,1570.7312817959491,1611.8426153871237
2021-04-28,Edmonton Oilers,3,Winnipeg Jets,1,2,0,0,1560.7703217217631,1510.1371256098507
2021-04-29,Buffalo Sabres,2,Boston Bruins,5,3,0,0,1391.0629896858568,1544.6185153593894
2021-04-29,Detroit Red Wings,1,Carolina Hurricanes,3,2,0,0,1424.3247963288338,1570.8660018324676
2021-04-29,Florida Panthers,4,Chicago Blackhawks,3,1,0,0,1561.7878537987594,1469.4897662316143
2021-04-29,Calgary Flames,3,Edmonton Oilers,1,2,0,1,1479.1422072880293,1551.802296788672
2021-04-29,St. Louis Blues,5,Minnesota Wild,4,1,1,1,1499.4592862623804,1563.4283501323073
2021-04-29,Philadelphia Flyers,3,New Jersey Devils,5,2,0,0,1455.751618203522,1406.2052543039608
2021-04-29,New York Islanders,4,New York Rangers,0,4,0,0,1547.966589611957,1514.4618519394494
2021-04-29,Dallas Stars,0,Tampa Bay Lightning,3,3,0,0,1470.6763121157894,1573.1433810601236
2021-04-29,Vancouver Canucks,1,Toronto Maple Leafs,4,3,1,1,1469.0182158304879,1559.9639970912035
2021-04-29,Pittsburgh Penguins,5,Washington Capitals,4,1,0,0,1568.291420768082,1571.6417601277824
2021-04-30,Los Angeles Kings,2,Anaheim Ducks,1,1,0,0,1447.3674580575382,1401.2483422377065
2021-04-30,Vegas Golden Knights,0,Arizona Coyotes,3,3,0,0,1601.0359997830224,1468.4414854613171
2021-04-30,San Jose Sharks,0,Colorado Avalanche,3,3,0,0,1443.523960891945,1575.495117173783
2021-04-30,Winnipeg Jets,3,Montreal Canadiens,5,2,0,0,1501.628693135154,1473.3794715363163
2021-05-01,Los Angeles Kings,2,Anaheim Ducks,6,4,1,1,1438.8397197093648,1409.77608058588
2021-05-01,Vegas Golden Knights,3,Arizona Coyotes,2,1,1,1,1606.6509688791098,1462.8265163652297
2021-05-01,Buffalo Sabres,2,Boston Bruins,6,4,0,0,1386.9131869538253,1548.768318091421
2021-05-01,Columbus Blue Jackets,1,Carolina Hurricanes,2,1,0,0,1399.0320417255766,1574.7462407050045
2021-05-01,Florida Panthers,5,Chicago Blackhawks,4,1,0,0,1568.2392343795102,1463.0383856508636
2021-05-01,San Jose Sharks,3,Colorado Avalanche,4,1,1,1,1438.952533428893,1580.066544636835
2021-05-01,Tampa Bay Lightning,0,Detroit Red Wings,1,1,0,0,1562.4399543794661,1435.0282230094913
2021-05-01,Calgary Flames,1,Edmonton Oilers,4,3,0,0,1473.319295743328,1557.6252083333734
2021-05-01,St. Louis Blues,3,Minnesota Wild,4,1,0,0,1493.4438070959932,1569.4438292986945
2021-05-01,Ottawa Senators,2,Montreal Canadiens,3,1,0,1,1456.1845268507348,1482.2600630157185
2021-05-01,Dallas Stars,0,Nashville Predators,1,1,0,0,1464.4854746217484,1532.9904455283393
2021-05-01,New York Rangers,0,New York Islanders,3,3,0,0,1507.7589444294417,1554.6694971219647
2021-05-01,New Jersey Devils,4,Philadelphia Flyers,1,3,0,0,1415.8664302980972,1446.0904422093856
2021-05-01,Vancouver Canucks,1,Toronto Maple Leafs,5,4,0,0,1463.5937661157868,1565.3884468059046
2021-05-01,Pittsburgh Penguins,3,Washington Capitals,0,3,0,0,1576.8965627916523,1563.036618104212
2021-05-02,Tampa Bay Lightning,2,Detroit Red Wings,1,1,1,1,1568.1589960418398,1429.3091813471176
2021-05-03,Los Angeles Kings,3,Arizona Coyotes,2,1,0,0,1447.9191602520514,1453.7470758225431
2021-05-03,New York Islanders,2,Buffalo Sabres,4,2,0,0,1543.609366210854,1397.973317864936
2021-05-03,Chicago Blackhawks,2,Carolina Hurricanes,5,3,0,0,1458.0534385849194,1579.7311877709487
2021-05-03,Nashville Predators,4,Columbus Blue Jackets,3,1,0,0,1538.5782128769165,1393.4442743769994
2021-05-03,Dallas Stars,4,Florida Panthers,5,1,0,0,1459.3339220276061,1573.3907869736524
2021-05-03,Vegas Golden Knights,5,Minnesota Wild,6,1,0,0,1598.3255029758411,1577.7692952019631
2021-05-03,Toronto Maple Leafs,2,Montreal Canadiens,3,1,0,0,1556.038052897521,1491.610456924102
2021-05-03,Boston Bruins,3,New Jersey Devils,0,3,0,0,1554.3771500396567,1410.2575983498614
2021-05-03,Washington Capitals,6,New York Rangers,3,3,0,0,1570.3024347623261,1500.4931277713276
2021-05-03,Winnipeg Jets,1,Ottawa Senators,2,1,0,0,1493.1162293138318,1464.696990672057
2021-05-03,Pittsburgh Penguins,2,Philadelphia Flyers,7,5,0,0,1566.547317979245,1456.439687021793
2021-05-03,Colorado Avalanche,5,San Jose Sharks,4,1,0,0,1585.512894406036,1433.5061836596922
2021-05-03,Anaheim Ducks,1,St. Louis Blues,3,2,0,0,1404.1942043761692,1499.025683305704
2021-05-03,Edmonton Oilers,5,Vancouver Canucks,3,2,0,0,1564.0394146843737,1457.1795597647865
2021-05-04,New York Islanders,3,Buffalo Sabres,4,1,1,1,1532.9674898292562,1408.6151942465337
2021-05-04,Chicago Blackhawks,3,Carolina Hurricanes,6,3,1,1,1453.2739803745808,1584.5106459812873
2021-05-04,Boston Bruins,3,New Jersey Devils,4,1,1,1,1543.7647608069246,1420.8699875825935
2021-05-04,Pittsburgh Penguins,7,Philadelphia Flyers,3,4,1,1,1572.6215979393864,1450.3654070616515
2021-05-04,Edmonton Oilers,4,Vancouver Canucks,1,3,1,1,1570.1816351416428,1451.0373393075174
2021-05-05,Los Angeles Kings,4,Arizona Coyotes,2,2,0,0,1456.581340382688,1445.0848956919065
2021-05-05,Nashville Predators,2,Columbus Blue Jackets,4,2,0,0,1527.946088401743,1404.0763988521728
2021-05-05,Winnipeg Jets,4,Calgary Flames,0,4,0,0,1501.1888807650923,1465.2466442920675
2021-05-05,Vegas Golden Knights,3,Minnesota Wild,2,1,0,0,1606.3807303274393,1569.714067850365
2021-05-05,Washington Capitals,4,New York Rangers,2,2,0,0,1577.244303821283,1493.5512587123708
2021-05-05,Montreal Canadiens,1,Ottawa Senators,5,4,0,0,1483.5199880176942,1472.7874595784647
2021-05-05,Colorado Avalanche,2,San Jose Sharks,3,1,0,0,1574.7482643043243,1444.2708137614038
2021-05-05,Anaheim Ducks,3,St. Louis Blues,2,1,0,0,1414.8531230133076,1488.3667646685656
2021-05-05,Dallas Stars,2,Tampa Bay Lightning,6,4,0,0,1454.2888580911906,1573.2040599782554
2021-05-06,New York Rangers,0,Boston Bruins,4,4,1,0,1488.827483809808,1548.4885357094875
2021-05-06,Chicago Blackhawks,2,Carolina Hurricanes,1,1,0,0,1464.687852648995,1573.0967737068731
2021-05-06,Vancouver Canucks,6,Edmonton Oilers,3,3,0,0,1462.20602789174,1559.0129465574203
2021-05-06,New Jersey Devils,2,New York Islanders,1,1,0,0,1431.8931425303913,1521.9443348814584
2021-05-06,Buffalo Sabres,4,Pittsburgh Penguins,8,4,0,0,1404.6620172658038,1576.5747749201164
2021-05-06,Montreal Canadiens,2,Toronto Maple Leafs,5,3,1,0,1479.293944930727,1560.2640959844882
2021-05-07,Detroit Red Wings,5,Columbus Blue Jackets,2,3,0,0,1437.2571944150739,1396.1283857842166
2021-05-07,Colorado Avalanche,3,Los Angeles Kings,2,1,0,0,1580.6556470711714,1450.673957615841
2021-05-07,Anaheim Ducks,3,Minnesota Wild,4,1,0,0,1410.7281561395212,1573.8390347241514
2021-05-07,Arizona Coyotes,5,San Jose Sharks,2,3,0,0,1453.5941507970342,1435.761558656276
2021-05-07,Dallas Stars,5,Tampa Bay Lightning,2,3,0,0,1465.452845326007,1562.040072743439
2021-05-07,St. Louis Blues,3,Vegas Golden Knights,4,1,0,0,1483.512237388171,1611.235257607834
2021-05-07,Philadelphia Flyers,4,Washington Capitals,2,2,0,0,1461.6916032234747,1565.9181076594598
2021-05-08,New York Rangers,5,Boston Bruins,4,1,0,0,1498.715885044762,1538.6001344745334
2021-05-08,Detroit Red Wings,4,Columbus Blue Jackets,5,1,1,1,1428.8425676274337,1404.5430125718567
2021-05-08,Vancouver Canucks,3,Edmonton Oilers,4,1,0,0,1456.9071410971774,1564.3118333519828
2021-05-08,Tampa Bay Lightning,1,Florida Panthers,5,4,1,0,1556.4293396513958,1579.0015200656956
2021-05-08,Colorado Avalanche,3,Los Angeles Kings,2,1,1,1,1586.3229440517596,1445.0066606352527
2021-05-08,Anaheim Ducks,3,Minnesota Wild,4,1,1,1,1406.7583294986039,1577.8088613650687
2021-05-08,Carolina Hurricanes,1,Nashville Predators,3,2,0,0,1564.5909539570118,1536.4519081516044
2021-05-08,New Jersey Devils,1,New York Islanders,5,4,0,0,1426.4494308551975,1527.3880465566522
2021-05-08,Buffalo Sabres,0,Pittsburgh Penguins,1,1,0,0,1400.854189445165,1580.3826027407551
2021-05-08,Arizona Coyotes,5,San Jose Sharks,4,1,1,1,1461.711900378891,1427.6438090744193
2021-05-08,Montreal Canadiens,2,Toronto Maple Leafs,3,1,0,0,1473.6533154400852,1565.9047254751301
2021-05-08,St. Louis Blues,1,Vegas Golden Knights,4,3,1,1,1478.8554777689797,1615.8920172270252
2021-05-08,Ottawa Senators,4,Winnipeg Jets,2,2,0,0,1481.9679736656965,1492.0083666778605
2021-05-08,Philadelphia Flyers,1,Washington Capitals,2,1,1,1,1456.5500162276194,1571.059694655315
2021-05-09,Ottawa Senators,1,Calgary Flames,6,5,1,0,1475.7112478279173,1471.5033701298466
2021-05-09,Dallas Stars,2,Chicago Blackhawks,4,2,0,0,1457.963230747129,1472.177467227873
2021-05-10,New York Islanders,2,Boston Bruins,3,1,0,0,1520.174124838901,1545.8140561922846
2021-05-10,Dallas Stars,5,Chicago Blackhawks,4,1,1,1,1466.818343153002,1463.322354822
2021-05-10,Tampa Bay Lightning,0,Florida Panthers,4,4,0,0,1549.476353294433,1585.9545064226584
2021-05-10,St. Louis Blues,2,Los Angeles Kings,1,1,0,0,1486.6065365301233,1437.255601874109
2021-05-10,Edmonton Oilers,4,Montreal Canadiens,3,1,0,0,1570.7984655602377,1467.1666832318303
2021-05-10,Carolina Hurricanes,0,Nashville Predators,5,5,0,0,1556.4724414628215,1544.5704206457947
2021-05-10,New Jersey Devils,2,Philadelphia Flyers,4,2,0,0,1419.6687935513312,1463.3306535314857
2021-05-10,Colorado Avalanche,2,Vegas Golden Knights,1,1,0,0,1595.5301580336857,1606.6848032450991
2021-05-10,Vancouver Canucks,3,Winnipeg Jets,1,2,0,0,1466.240637992527,1482.674869782511
2021-05-11,Vancouver Canucks,0,Winnipeg Jets,5,5,1,1,1459.1467681921488,1489.768739582889
2021-05-11,Boston Bruins,1,Washington Capitals,2,1,1,0,1540.5223375872602,1576.3514132603395
2021-05-12,Los Angeles Kings,0,Colorado Avalanche,6,6,0,0,1433.1952103223691,1599.5905495854256
2021-05-12,Edmonton Oilers,4,Montreal Canadiens,3,1,0,0,1577.0085907531134,1460.9565580389547
2021-05-12,Toronto Maple Leafs,3,Ottawa Senators,4,1,0,0,1556.4013718271758,1485.2146014758716
2021-05-12,Vegas Golden Knights,6,San Jose Sharks,0,6,0,0,1611.4201552597817,1422.9084570597367
2021-05-12,Minnesota Wild,0,St. Louis Blues,4,4,0,0,1568.2837919496594,1496.1316059455326
2021-05-13,Vancouver Canucks,1,Calgary Flames,4,3,0,0,1451.9591695652216,1478.6909687567738
2021-05-13,Los Angeles Kings,1,Colorado Avalanche,5,4,1,1,1429.2862638608199,1603.4994960469749
2021-05-13,Minnesota Wild,3,St. Louis Blues,7,4,1,1,1559.1739048310326,1505.2414930641594
2021-05-14,Toronto Maple Leafs,2,Winnipeg Jets,4,2,0,0,1547.4136368544189,1498.756474555646
2021-05-15,Vancouver Canucks,4,Edmonton Oilers,1,3,0,0,1463.2483263128647,1565.7194340054702
2021-05-16,Calgary Flames,6,Vancouver Canucks,5,1,0,1,1485.2636227479127,1456.6756723217259
2021-05-18,Calgary Flames,2,Vancouver Canucks,4,2,0,0,1477.1348424268765,1464.804452642762
2021-05-19,Vancouver Canucks,2,Calgary Flames,6,4,1,1,1457.6162512198628,1484.3230438497758
2021-05-15,Boston Bruins,2,Washington Capitals,3,1,0,0,1533.872420422873,1583.0013304247268
2021-05-16,Tampa Bay Lightning,5,Florida Panthers,4,1,0,0,1558.841221014726,1576.5896387023654
2021-05-16,Minnesota Wild,1,Vegas Golden Knights,0,1,0,0,1568.8959324896684,1601.6981276011459
2021-05-16,New York Islanders,4,Pittsburgh Penguins,3,1,0,0,1530.0747632364767,1570.4819643431795
2021-05-17,Nashville Predators,2,Carolina Hurricanes,5,3,0,0,1537.3723676499405,1563.6704944586756
2021-05-17,Boston Bruins,4,Washington Capitals,3,1,0,0,1543.524175445522,1573.3495754020778
2021-05-17,St. Louis Blues,1,Colorado Avalanche,4,3,0,0,1499.973518038922,1608.7674710722122
2021-05-18,Tampa Bay Lightning,3,Florida Panthers,1,2,0,0,1567.7775383174737,1567.6533213996177
2021-05-18,New York Islanders,1,Pittsburgh Penguins,2,1,0,0,1523.5290010930257,1577.0277264866304
2021-05-18,Minnesota Wild,1,Vegas Golden Knights,3,2,0,0,1562.176994753384,1608.4170653374304
2021-05-19,Washington Capitals,2,Boston Bruins,3,1,0,0,1565.1925021904203,1551.6812486571794
2021-05-19,Nashville Predators,0,Carolina Hurricanes,3,3,0,0,1530.5047506091744,1570.5381114994418
2021-05-19,St. Louis Blues,3,Colorado Avalanche,6,3,0,0,1494.927803446372,1613.8131856647622
2021-05-19,Winnipeg Jets,4,Edmonton Oilers,1,3,0,0,1508.80754123027,1555.6683673308462
2021-05-20,Pittsburgh Penguins,5,New York Islanders,4,1,0,0,1584.3335172526454,1516.2232103270107
2021-05-20,Montreal Canadiens,2,Toronto Maple Leafs,1,1,0,0,1471.435207680588,1536.9349872127855
2021-05-20,Florida Panthers,6,Tampa Bay Lightning,5,1,0,0,1576.1841815997293,1559.246678117362
2021-05-20,Vegas Golden Knights,5,Minnesota Wild,2,3,0,0,1615.8865905320172,1554.7074695587971
2021-05-21,Washington Capitals,1,Boston Bruins,4,3,0,0,1557.4095508171831,1559.4642000304166
2021-05-21,Winnipeg Jets,1,Edmonton Oilers,0,1,0,0,1518.4080559084757,1546.0678526526406
2021-05-21,Carolina Hurricanes,4,Nashville Predators,5,1,0,0,1562.1483672972076,1538.8944948114085
2021-05-21,Colorado Avalanche,5,St. Louis Blues,1,4,0,0,1619.7058105243646,1489.0351785867697
2021-05-22,Montreal Canadiens,1,Toronto Maple Leafs,5,4,0,0,1465.4537786868157,1542.9164162065579
2021-05-22,Pittsburgh Penguins,1,New York Islanders,4,3,0,0,1575.3130055816139,1525.2437219980422
2021-05-22,Vegas Golden Knights,4,Minnesota Wild,0,4,0,0,1623.0202706733826,1547.5737894174317
2021-05-22,Florida Panthers,2,Tampa Bay Lightning,6,4,0,0,1568.3224898301487,1567.1083698869427
2021-05-23,Carolina Hurricanes,3,Nashville Predators,4,1,0,0,1554.1417251901244,1546.9011369184918
2021-05-23,Colorado Avalanche,5,St. Louis Blues,2,3,0,0,1625.359282288911,1483.3817068222234
2021-05-23,Edmonton Oilers,4,Winnipeg Jets,5,1,0,0,1537.9603044217827,1526.5156041393336
2021-05-23,Boston Bruins,3,Washington Capitals,1,2,0,0,1567.9448905354286,1548.928860312171
2021-05-24,Minnesota Wild,4,Vegas Golden Knights,2,2,0,0,1557.8122079582492,1612.781852132565
2021-05-24,Edmonton Oilers,3,Winnipeg Jets,4,1,1,1,1530.2248757323193,1534.251032828797
2021-05-24,New York Islanders,3,Pittsburgh Penguins,2,1,0,0,1534.9166945565664,1565.6400330230897
2021-05-24,Toronto Maple Leafs,2,Montreal Canadiens,1,1,0,0,1549.6897514389204,1458.680443454453
2021-05-24,Tampa Bay Lightning,1,Florida Panthers,4,3,0,0,1559.6643259179696,1575.7665337991218
2021-05-25,Nashville Predators,2,Carolina Hurricanes,3,1,0,0,1539.5958334927552,1561.447028615861
2021-05-25,Toronto Maple Leafs,4,Montreal Canadiens,0,4,1,1,1556.1688342818707,1452.2013606115029
2021-05-26,Vegas Golden Knights,0,Minnesota Wild,3,3,0,0,1604.0545858456614,1566.5394742451529
2021-05-26,Pittsburgh Penguins,3,New York Islanders,5,2,0,0,1557.4624402201532,1543.094287359503
2021-05-26,Florida Panthers,0,Tampa Bay Lightning,4,4,0,0,1567.9240319947821,1567.5068277223093
2021-05-27,Carolina Hurricanes,4,Nashville Predators,3,1,0,0,1569.4725486001926,1531.5703135084236
2021-05-27,Montreal Canadiens,4,Toronto Maple Leafs,3,1,0,0,1463.0543141464238,1545.3158807469497
2021-05-28,Minnesota Wild,2,Vegas Golden Knights,6,4,0,0,1559.9279500930018,1610.6661099978126
2021-05-29,Toronto Maple Leafs,2,Montreal Canadiens,3,1,0,0,1535.9843566922773,1472.3858382010962
2021-05-29,New York Islanders,2,Boston Bruins,5,3,0,0,1536.1935198458345,1574.845658049097
2021-05-30,Vegas Golden Knights,1,Colorado Avalanche,7,6,0,0,1603.5322312430594,1632.493161043664
2021-05-30,Tampa Bay Lightning,2,Carolina Hurricanes,1,1,0,0,1576.0800896352591,1560.8992866872427
2021-05-31,New York Islanders,4,Boston Bruins,3,1,0,0,1545.607864611335,1565.4313132835966
2021-05-31,Montreal Canadiens,3,Toronto Maple Leafs,1,2,0,0,1482.3621081333235,1526.00808676005
2021-06-01,Tampa Bay Lightning,2,Carolina Hurricanes,1,1,0,0,1584.2587610086364,1552.7206153138654
2021-06-02,Vegas Golden Knights,2,Colorado Avalanche,3,1,0,0,1596.7255410922564,1639.299851194467
2021-06-02,Montreal Canadiens,5,Winnipeg Jets,3,2,0,0,1492.0760901164845,1524.537050845636
2021-06-03,Boston Bruins,2,New York Islanders,1,1,0,0,1573.5033561826788,1537.5358217122528
2021-06-03,Carolina Hurricanes,3,Tampa Bay Lightning,2,1,0,0,1561.9728199144565,1575.0065564080453
2021-06-04,Colorado Avalanche,2,Vegas Golden Knights,3,1,0,0,1630.8524188744525,1605.172973412271
2021-06-04,Montreal Canadiens,1,Winnipeg Jets,0,1,0,0,1501.34936407324,1515.2637768888806
2021-06-05,Boston Bruins,1,New York Islanders,4,3,0,0,1565.206119010464,1545.8330588844676
2021-06-05,Carolina Hurricanes,4,Tampa Bay Lightning,6,2,0,0,1554.8007920834352,1582.1785842390666
2021-06-06,Winnipeg Jets,1,Montreal Canadiens,5,4,0,0,1507.4715568771298,1509.1415840849907
2021-06-06,Colorado Avalanche,1,Vegas Golden Knights,5,4,0,0,1622.790202163617,1613.2351901231063
2021-06-07,New York Islanders,5,Boston Bruins,4,1,0,0,1554.8066783355418,1556.2324995593897
2021-06-07,Winnipeg Jets,2,Montreal Canadiens,3,1,1,1,1500.0380103785164,1516.575130583604
2021-06-08,Vegas Golden Knights,3,Colorado Avalanche,2,1,0,0,1621.983146955138,1614.0422453315855
2021-06-08,Tampa Bay Lightning,2,Carolina Hurricanes,0,2,0,0,1590.077488836901,1546.9018874856008
2021-06-09,Boston Bruins,2,New York Islanders,6,4,0,0,1548.727668996742,1562.3115088981895
2021-06-10,Colorado Avalanche,3,Vegas Golden Knights,6,3,0,0,1606.7530595165733,1629.2723327701501
2021-06-13,New York Islanders,2,Tampa Bay Lightning,1,1,0,0,1571.4774865975912,1580.9115111374992
2021-06-14,Montreal Canadiens,1,Vegas Golden Knights,4,3,0,0,1511.6107441388476,1634.2367192149065
2021-06-15,New York Islanders,2,Tampa Bay Lightning,4,2,0,0,1564.222659668894,1588.1663380661964
2021-06-16,Montreal Canadiens,3,Vegas Golden Knights,2,1,0,0,1522.850628545901,1622.9968348078532
2021-06-17,Tampa Bay Lightning,2,New York Islanders,1,1,0,0,1596.143885649243,1556.2451120858475
2021-06-18,Vegas Golden Knights,2,Montreal Canadiens,3,1,0,0,1613.2806928338566,1532.5667705198975
2021-06-19,Tampa Bay Lightning,2,New York Islanders,3,1,0,0,1587.7571997871134,1564.631797947977
2021-06-20,Vegas Golden Knights,2,Montreal Canadiens,1,1,0,0,1619.982913968996,1525.8645493847582
2021-06-21,New York Islanders,0,Tampa Bay Lightning,8,8,0,0,1557.6914950483797,1594.6975026867108
2021-06-22,Montreal Canadiens,4,Vegas Golden Knights,1,3,0,0,1536.5082046412228,1609.3392587125313
2021-06-23,Tampa Bay Lightning,2,New York Islanders,3,1,0,0,1586.3766155903043,1566.0123821447862
2021-06-24,Vegas Golden Knights,2,Montreal Canadiens,3,1,0,0,1600.2144013096188,1545.6330620441354
2021-06-25,New York Islanders,0,Tampa Bay Lightning,1,1,0,0,1559.0087497152615,1593.380248019829
2021-06-28,Montreal Canadiens,1,Tampa Bay Lightning,5,4,0,0,1539.2536121973394,1599.759697866625
2021-06-30,Montreal Canadiens,1,Tampa Bay Lightning,3,2,0,0,1533.1609005479022,1605.8524095160622
2021-07-02,Tampa Bay Lightning,6,Montreal Canadiens,3,3,0,0,1612.7306283550179,1526.2826817089465
2021-07-05,Tampa Bay Lightning,2,Montreal Canadiens,3,1,0,0,1603.3081764889475,1535.7051335750168
2021-07-07,Montreal Canadiens,0,Tampa Bay Lightning,1,1,0,0,1529.7703995119734,1609.242910551991
