,Date,Away,Away_Goals,Home,Home_Goals,MOV,Away_B2B,Home_B2B
"15,0",2021-10-12,Pittsburgh Penguins,6,Tampa Bay Lightning,2,4,0,0
"15,1",2021-10-12,Seattle Kraken,3,Vegas Golden Knights,4,1,0,0
"16,0",2021-10-13,Montréal Canadiens,1,Toronto Maple Leafs,2,1,0,0
"16,1",2021-10-13,New York Rangers,1,Washington Capitals,5,4,0,0
"16,2",2021-10-13,Chicago Blackhawks,2,Colorado Avalanche,4,2,0,0
"16,3",2021-10-13,Vancouver Canucks,2,Edmonton Oilers,3,1,0,0
"16,4",2021-10-13,Winnipeg Jets,1,Anaheim Ducks,4,3,0,0
"17,0",2021-10-14,Montréal Canadiens,1,Buffalo Sabres,5,4,1,0
"17,1",2021-10-14,Toronto Maple Leafs,2,Ottawa Senators,3,1,1,0
"17,2",2021-10-14,Pittsburgh Penguins,4,Florida Panthers,5,1,0,0
"17,3",2021-10-14,Dallas Stars,3,New York Rangers,2,1,0,1
"17,4",2021-10-14,New York Islanders,3,Carolina Hurricanes,6,3,0,0
"17,5",2021-10-14,Arizona Coyotes,2,Columbus Blue Jackets,8,6,0,0
"17,6",2021-10-14,Tampa Bay Lightning,7,Detroit Red Wings,6,1,0,0
"17,7",2021-10-14,Seattle Kraken,4,Nashville Predators,3,1,0,0
"17,8",2021-10-14,Vegas Golden Knights,2,Los Angeles Kings,6,4,0,0
"18,0",2021-10-15,Chicago Blackhawks,3,New Jersey Devils,4,1,0,0
"18,1",2021-10-15,Vancouver Canucks,5,Philadelphia Flyers,4,1,0,0
"18,2",2021-10-15,Minnesota Wild,2,Anaheim Ducks,1,1,0,0
"19,0",2021-10-16,New York Rangers,2,Montréal Canadiens,1,1,0,0
"19,1",2021-10-16,Carolina Hurricanes,1,Nashville Predators,1,0,0,0
"19,2",2021-10-16,St. Louis Blues,1,Colorado Avalanche,0,1,0,0
"19,3",2021-10-16,Calgary Flames,0,Edmonton Oilers,0,0,0,0
"19,4",2021-10-16,Winnipeg Jets,0,San Jose Sharks,0,0,0,0
"19,5",2021-10-16,Minnesota Wild,0,Los Angeles Kings,0,0,1,0
"19,6",2021-10-16,Arizona Coyotes,1,Buffalo Sabres,2,1,0,0
"19,7",2021-10-16,New York Islanders,1,Florida Panthers,5,4,0,0
"19,8",2021-10-16,Dallas Stars,1,Boston Bruins,3,2,0,0
"19,9",2021-10-16,Ottawa Senators,1,Toronto Maple Leafs,3,2,0,0
"19,10",2021-10-16,Vancouver Canucks,1,Detroit Red Wings,3,2,1,0
"19,11",2021-10-16,Chicago Blackhawks,2,Pittsburgh Penguins,5,3,1,0
"19,12",2021-10-16,Tampa Bay Lightning,2,Washington Capitals,1,1,0,0
"19,13",2021-10-16,Seattle Kraken,1,Columbus Blue Jackets,2,1,0,0
"20,0",2021-10-17,Dallas Stars,0,Ottawa Senators,0,0,1,1
"21,0",2021-10-18,New York Rangers,0,Toronto Maple Leafs,0,0,0,0
"21,1",2021-10-18,Seattle Kraken,0,Philadelphia Flyers,0,0,0,0
"21,2",2021-10-18,Anaheim Ducks,0,Calgary Flames,0,0,0,0
"21,3",2021-10-18,St. Louis Blues,0,Arizona Coyotes,0,0,0,0
"22,0",2021-10-19,Vancouver Canucks,0,Buffalo Sabres,0,0,0,0
"22,1",2021-10-19,San Jose Sharks,0,Montréal Canadiens,0,0,0,0
"22,2",2021-10-19,Florida Panthers,0,Tampa Bay Lightning,0,0,0,0
"22,3",2021-10-19,Seattle Kraken,0,New Jersey Devils,0,0,1,0
"22,4",2021-10-19,Dallas Stars,0,Pittsburgh Penguins,0,0,0,0
"22,5",2021-10-19,Colorado Avalanche,0,Washington Capitals,0,0,0,0
"22,6",2021-10-19,Columbus Blue Jackets,0,Detroit Red Wings,0,0,0,0
"22,7",2021-10-19,New York Islanders,0,Chicago Blackhawks,0,0,0,0
"22,8",2021-10-19,Los Angeles Kings,0,Nashville Predators,0,0,0,0
"22,9",2021-10-19,Winnipeg Jets,0,Minnesota Wild,0,0,0,0
"22,10",2021-10-19,Anaheim Ducks,0,Edmonton Oilers,0,0,1,0
"23,0",2021-10-20,Boston Bruins,0,Philadelphia Flyers,0,0,0,0
"23,1",2021-10-20,St. Louis Blues,0,Vegas Golden Knights,0,0,0,0
"24,0",2021-10-21,Carolina Hurricanes,0,Montréal Canadiens,0,0,0,0
"24,1",2021-10-21,San Jose Sharks,0,Ottawa Senators,0,0,0,0
"24,2",2021-10-21,Colorado Avalanche,0,Florida Panthers,0,0,0,0
"24,3",2021-10-21,Washington Capitals,0,New Jersey Devils,0,0,0,0
"24,4",2021-10-21,New York Islanders,0,Columbus Blue Jackets,0,0,0,0
"24,5",2021-10-21,Calgary Flames,0,Detroit Red Wings,0,0,0,0
"24,6",2021-10-21,New York Rangers,0,Nashville Predators,0,0,0,0
"24,7",2021-10-21,Anaheim Ducks,0,Winnipeg Jets,0,0,0,0
"24,8",2021-10-21,Vancouver Canucks,0,Chicago Blackhawks,0,0,0,0
"24,9",2021-10-21,Edmonton Oilers,0,Arizona Coyotes,0,0,0,0
"25,0",2021-10-22,San Jose Sharks,0,Toronto Maple Leafs,0,0,1,0
"25,1",2021-10-22,Boston Bruins,0,Buffalo Sabres,0,0,0,0
"25,2",2021-10-22,Los Angeles Kings,0,Dallas Stars,0,0,0,0
"25,3",2021-10-22,Edmonton Oilers,0,Vegas Golden Knights,0,0,1,0
"26,0",2021-10-23,New York Rangers,0,Ottawa Senators,0,0,0,0
"26,1",2021-10-23,Calgary Flames,0,Washington Capitals,0,0,0,0
"26,2",2021-10-23,Anaheim Ducks,0,Minnesota Wild,0,0,0,0
"26,3",2021-10-23,Detroit Red Wings,0,Montréal Canadiens,0,0,0,0
"26,4",2021-10-23,Colorado Avalanche,0,Tampa Bay Lightning,0,0,0,0
"26,5",2021-10-23,Buffalo Sabres,0,New Jersey Devils,0,0,1,0
"26,6",2021-10-23,Florida Panthers,0,Philadelphia Flyers,0,0,0,0
"26,7",2021-10-23,Toronto Maple Leafs,0,Pittsburgh Penguins,0,0,1,0
"26,8",2021-10-23,Carolina Hurricanes,0,Columbus Blue Jackets,0,0,0,0
"26,9",2021-10-23,Nashville Predators,0,Winnipeg Jets,0,0,0,0
"26,10",2021-10-23,Los Angeles Kings,0,St. Louis Blues,0,0,1,0
"26,11",2021-10-23,New York Islanders,0,Arizona Coyotes,0,0,0,0
"26,12",2021-10-23,Vancouver Canucks,0,Seattle Kraken,0,0,0,0
"27,0",2021-10-24,San Jose Sharks,0,Boston Bruins,0,0,0,0
"27,1",2021-10-24,Nashville Predators,0,Minnesota Wild,0,0,1,1
"27,2",2021-10-24,Detroit Red Wings,0,Chicago Blackhawks,0,0,1,0
"27,3",2021-10-24,New York Islanders,0,Vegas Golden Knights,0,0,1,0
"28,0",2021-10-25,Tampa Bay Lightning,0,Buffalo Sabres,0,0,0,0
"28,1",2021-10-25,Washington Capitals,0,Ottawa Senators,0,0,0,0
"28,2",2021-10-25,Arizona Coyotes,0,Florida Panthers,0,0,0,0
"28,3",2021-10-25,Calgary Flames,0,New York Rangers,0,0,0,0
"28,4",2021-10-25,Toronto Maple Leafs,0,Carolina Hurricanes,0,0,0,0
"28,5",2021-10-25,Dallas Stars,0,Columbus Blue Jackets,0,0,0,0
"28,6",2021-10-25,Los Angeles Kings,0,St. Louis Blues,0,0,0,0
"29,0",2021-10-26,Calgary Flames,0,New Jersey Devils,0,0,1,0
"29,1",2021-10-26,Tampa Bay Lightning,0,Pittsburgh Penguins,0,0,1,0
"29,2",2021-10-26,Vegas Golden Knights,0,Colorado Avalanche,0,0,0,0
"29,3",2021-10-26,San Jose Sharks,0,Nashville Predators,0,0,0,0
"29,4",2021-10-26,Minnesota Wild,0,Vancouver Canucks,0,0,0,0
"29,5",2021-10-26,Winnipeg Jets,0,Anaheim Ducks,0,0,0,0
"29,6",2021-10-26,Montréal Canadiens,0,Seattle Kraken,0,0,0,0
"30,0",2021-10-27,Boston Bruins,0,Florida Panthers,0,0,0,0
"30,1",2021-10-27,Detroit Red Wings,0,Washington Capitals,0,0,0,0
"30,2",2021-10-27,Toronto Maple Leafs,0,Chicago Blackhawks,0,0,0,0
"30,3",2021-10-27,Vegas Golden Knights,0,Dallas Stars,0,0,1,0
"30,4",2021-10-27,Philadelphia Flyers,0,Edmonton Oilers,0,0,0,0
"31,0",2021-10-28,Arizona Coyotes,0,Tampa Bay Lightning,0,0,0,0
"31,1",2021-10-28,Calgary Flames,0,Pittsburgh Penguins,0,0,0,0
"31,2",2021-10-28,Boston Bruins,0,Carolina Hurricanes,0,0,1,0
"31,3",2021-10-28,Colorado Avalanche,0,St. Louis Blues,0,0,0,0
"31,4",2021-10-28,Philadelphia Flyers,0,Vancouver Canucks,0,0,1,0
"31,5",2021-10-28,Buffalo Sabres,0,Anaheim Ducks,0,0,0,0
"31,6",2021-10-28,Minnesota Wild,0,Seattle Kraken,0,0,0,0
"31,7",2021-10-28,Winnipeg Jets,0,Los Angeles Kings,0,0,0,0
"31,8",2021-10-28,Montréal Canadiens,0,San Jose Sharks,0,0,0,0
"32,0",2021-10-29,Florida Panthers,0,Detroit Red Wings,0,0,0,0
"32,1",2021-10-29,Columbus Blue Jackets,0,New York Rangers,0,0,0,0
"32,2",2021-10-29,Arizona Coyotes,0,Washington Capitals,0,0,1,0
"32,3",2021-10-29,Chicago Blackhawks,0,Carolina Hurricanes,0,0,0,1
"32,4",2021-10-29,Anaheim Ducks,0,Vegas Golden Knights,0,0,1,0
"32,5",2021-10-29,Ottawa Senators,0,Dallas Stars,0,0,0,0
"33,0",2021-10-30,New York Islanders,0,Nashville Predators,0,0,0,0
"33,1",2021-10-30,Montréal Canadiens,0,Los Angeles Kings,0,0,0,0
"33,2",2021-10-30,Florida Panthers,0,Boston Bruins,0,0,1,0
"33,3",2021-10-30,Detroit Red Wings,0,Toronto Maple Leafs,0,0,1,0
"33,4",2021-10-30,New Jersey Devils,0,Pittsburgh Penguins,0,0,0,0
"33,5",2021-10-30,Winnipeg Jets,0,San Jose Sharks,0,0,0,0
"33,6",2021-10-30,Chicago Blackhawks,0,St. Louis Blues,0,0,1,0
"33,7",2021-10-30,Minnesota Wild,0,Colorado Avalanche,0,0,0,0
"33,8",2021-10-30,Philadelphia Flyers,0,Calgary Flames,0,0,0,0
"33,9",2021-10-30,Edmonton Oilers,0,Vancouver Canucks,0,0,0,0
"34,0",2021-10-31,Arizona Coyotes,0,Carolina Hurricanes,0,0,0,0
"34,1",2021-10-31,Montréal Canadiens,0,Anaheim Ducks,0,0,1,0
"34,2",2021-10-31,Buffalo Sabres,0,Los Angeles Kings,0,0,0,1
"34,3",2021-10-31,Columbus Blue Jackets,0,New Jersey Devils,0,0,0,1
"34,4",2021-10-31,New York Rangers,0,Seattle Kraken,0,0,0,0
"35,0",2021-11-01,Washington Capitals,0,Tampa Bay Lightning,0,0,0,0
"35,1",2021-11-01,Ottawa Senators,0,Chicago Blackhawks,0,0,0,0
"35,2",2021-11-01,Seattle Kraken,0,Edmonton Oilers,0,0,1,0
"36,0",2021-11-02,Vegas Golden Knights,0,Toronto Maple Leafs,0,0,0,0
"36,1",2021-11-02,Detroit Red Wings,0,Montréal Canadiens,0,0,0,0
"36,2",2021-11-02,Arizona Coyotes,0,Philadelphia Flyers,0,0,0,0
"36,3",2021-11-02,Ottawa Senators,0,Minnesota Wild,0,0,1,0
"36,4",2021-11-02,Dallas Stars,0,Winnipeg Jets,0,0,0,0
"36,5",2021-11-02,Nashville Predators,0,Calgary Flames,0,0,0,0
"36,6",2021-11-02,New York Rangers,0,Vancouver Canucks,0,0,0,0
"36,7",2021-11-02,New Jersey Devils,0,Anaheim Ducks,0,0,0,0
"36,8",2021-11-02,Buffalo Sabres,0,San Jose Sharks,0,0,0,0
"37,0",2021-11-03,Carolina Hurricanes,0,Chicago Blackhawks,0,0,0,0
"37,1",2021-11-03,Nashville Predators,0,Edmonton Oilers,0,0,1,0
"37,2",2021-11-03,Columbus Blue Jackets,0,Colorado Avalanche,0,0,0,0
"37,3",2021-11-03,St. Louis Blues,0,Los Angeles Kings,0,0,0,0
"38,0",2021-11-04,Detroit Red Wings,0,Boston Bruins,0,0,0,0
"38,1",2021-11-04,Tampa Bay Lightning,0,Toronto Maple Leafs,0,0,0,0
"38,2",2021-11-04,New York Islanders,0,Montréal Canadiens,0,0,0,0
"38,3",2021-11-04,Vegas Golden Knights,0,Ottawa Senators,0,0,0,0
"38,4",2021-11-04,Washington Capitals,0,Florida Panthers,0,0,0,0
"38,5",2021-11-04,Philadelphia Flyers,0,Pittsburgh Penguins,0,0,0,0
"38,6",2021-11-04,Dallas Stars,0,Calgary Flames,0,0,0,0
"38,7",2021-11-04,Buffalo Sabres,0,Seattle Kraken,0,0,0,0
"38,8",2021-11-04,St. Louis Blues,0,San Jose Sharks,0,0,1,0
"39,0",2021-11-05,Chicago Blackhawks,0,Winnipeg Jets,0,0,0,0
"39,1",2021-11-05,New York Rangers,0,Edmonton Oilers,0,0,0,0
"39,2",2021-11-05,Nashville Predators,0,Vancouver Canucks,0,0,0,0
"39,3",2021-11-05,Arizona Coyotes,0,Anaheim Ducks,0,0,0,0
"39,4",2021-11-05,New Jersey Devils,0,Los Angeles Kings,0,0,0,0
"40,0",2021-11-06,Tampa Bay Lightning,0,Ottawa Senators,0,0,0,0
"40,1",2021-11-06,Carolina Hurricanes,0,Florida Panthers,0,0,0,0
"40,2",2021-11-06,Detroit Red Wings,0,Buffalo Sabres,0,0,0,0
"40,3",2021-11-06,Boston Bruins,0,Toronto Maple Leafs,0,0,0,0
"40,4",2021-11-06,Vegas Golden Knights,0,Montréal Canadiens,0,0,0,0
"40,5",2021-11-06,Minnesota Wild,0,Pittsburgh Penguins,0,0,0,0
"40,6",2021-11-06,Philadelphia Flyers,0,Washington Capitals,0,0,0,0
"40,7",2021-11-06,Colorado Avalanche,0,Columbus Blue Jackets,0,0,0,0
"40,8",2021-11-06,New York Islanders,0,Winnipeg Jets,0,0,0,1
"40,9",2021-11-06,New York Rangers,0,Calgary Flames,0,0,1,0
"40,10",2021-11-06,Seattle Kraken,0,Arizona Coyotes,0,0,0,1
"40,11",2021-11-06,New Jersey Devils,0,San Jose Sharks,0,0,1,0
"41,0",2021-11-07,Vegas Golden Knights,0,Detroit Red Wings,0,0,1,1
"41,1",2021-11-07,Nashville Predators,0,Chicago Blackhawks,0,0,0,0
"41,2",2021-11-07,New York Islanders,0,Minnesota Wild,0,0,1,1
"41,3",2021-11-07,St. Louis Blues,0,Anaheim Ducks,0,0,0,0
"41,4",2021-11-07,Dallas Stars,0,Vancouver Canucks,0,0,0,0
"42,0",2021-11-08,Florida Panthers,0,New York Rangers,0,0,0,0
"42,1",2021-11-08,Buffalo Sabres,0,Washington Capitals,0,0,0,0
"42,2",2021-11-08,Los Angeles Kings,0,Toronto Maple Leafs,0,0,0,0
"43,0",2021-11-09,Ottawa Senators,0,Boston Bruins,0,0,0,0
"43,1",2021-11-09,Los Angeles Kings,0,Montréal Canadiens,0,0,1,0
"43,2",2021-11-09,Carolina Hurricanes,0,Tampa Bay Lightning,0,0,0,0
"43,3",2021-11-09,Florida Panthers,0,New Jersey Devils,0,0,1,0
"43,4",2021-11-09,Edmonton Oilers,0,Detroit Red Wings,0,0,0,0
"43,5",2021-11-09,St. Louis Blues,0,Winnipeg Jets,0,0,0,0
"43,6",2021-11-09,Pittsburgh Penguins,0,Chicago Blackhawks,0,0,0,0
"43,7",2021-11-09,San Jose Sharks,0,Calgary Flames,0,0,0,0
"43,8",2021-11-09,Anaheim Ducks,0,Vancouver Canucks,0,0,0,0
"43,9",2021-11-09,Seattle Kraken,0,Vegas Golden Knights,0,0,0,0
"44,0",2021-11-10,Toronto Maple Leafs,0,Philadelphia Flyers,0,0,0,0
"44,1",2021-11-10,Nashville Predators,0,Dallas Stars,0,0,0,0
"44,2",2021-11-10,Minnesota Wild,0,Arizona Coyotes,0,0,0,0
"45,0",2021-11-11,Edmonton Oilers,0,Boston Bruins,0,0,0,0
"45,1",2021-11-11,Calgary Flames,0,Montréal Canadiens,0,0,0,0
"45,2",2021-11-11,Los Angeles Kings,0,Ottawa Senators,0,0,0,0
"45,3",2021-11-11,New York Islanders,0,New Jersey Devils,0,0,0,0
"45,4",2021-11-11,Florida Panthers,0,Pittsburgh Penguins,0,0,0,0
"45,5",2021-11-11,Washington Capitals,0,Detroit Red Wings,0,0,0,0
"45,6",2021-11-11,Nashville Predators,0,St. Louis Blues,0,0,1,0
"45,7",2021-11-11,San Jose Sharks,0,Winnipeg Jets,0,0,0,0
"45,8",2021-11-11,Vancouver Canucks,0,Colorado Avalanche,0,0,0,0
"45,9",2021-11-11,Minnesota Wild,0,Vegas Golden Knights,0,0,1,0
"45,10",2021-11-11,Anaheim Ducks,0,Seattle Kraken,0,0,0,0
"46,0",2021-11-12,Calgary Flames,0,Toronto Maple Leafs,0,0,1,0
"46,1",2021-11-12,Edmonton Oilers,0,Buffalo Sabres,0,0,1,0
"46,2",2021-11-12,Philadelphia Flyers,0,Carolina Hurricanes,0,0,0,0
"46,3",2021-11-12,Washington Capitals,0,Columbus Blue Jackets,0,0,1,0
"46,4",2021-11-12,Arizona Coyotes,0,Chicago Blackhawks,0,0,0,0
"47,0",2021-11-13,Boston Bruins,0,New Jersey Devils,0,0,0,0
"47,1",2021-11-13,Toronto Maple Leafs,0,Buffalo Sabres,0,0,1,1
"47,2",2021-11-13,Pittsburgh Penguins,0,Ottawa Senators,0,0,0,0
"47,3",2021-11-13,Montréal Canadiens,0,Detroit Red Wings,0,0,0,0
"47,4",2021-11-13,Florida Panthers,0,Tampa Bay Lightning,0,0,0,0
"47,5",2021-11-13,New York Rangers,0,Columbus Blue Jackets,0,0,0,1
"47,6",2021-11-13,Los Angeles Kings,0,Winnipeg Jets,0,0,0,0
"47,7",2021-11-13,St. Louis Blues,0,Carolina Hurricanes,0,0,0,1
"47,8",2021-11-13,Arizona Coyotes,0,Nashville Predators,0,0,1,0
"47,9",2021-11-13,Philadelphia Flyers,0,Dallas Stars,0,0,1,0
"47,10",2021-11-13,San Jose Sharks,0,Colorado Avalanche,0,0,0,0
"47,11",2021-11-13,Vancouver Canucks,0,Vegas Golden Knights,0,0,0,0
"47,12",2021-11-13,Minnesota Wild,0,Seattle Kraken,0,0,0,0
"48,0",2021-11-14,Calgary Flames,0,Ottawa Senators,0,0,0,1
"48,1",2021-11-14,Montréal Canadiens,0,Boston Bruins,0,0,1,1
"48,2",2021-11-14,New Jersey Devils,0,New York Rangers,0,0,1,1
"48,3",2021-11-14,Pittsburgh Penguins,0,Washington Capitals,0,0,1,0
"48,4",2021-11-14,Edmonton Oilers,0,St. Louis Blues,0,0,0,1
"48,5",2021-11-14,Vancouver Canucks,0,Anaheim Ducks,0,0,1,0
"49,0",2021-11-15,New York Islanders,0,Tampa Bay Lightning,0,0,0,0
"49,1",2021-11-15,Detroit Red Wings,0,Columbus Blue Jackets,0,0,0,0
"50,0",2021-11-16,Nashville Predators,0,Toronto Maple Leafs,0,0,0,0
"50,1",2021-11-16,New York Islanders,0,Florida Panthers,0,0,1,0
"50,2",2021-11-16,Ottawa Senators,0,New Jersey Devils,0,0,0,0
"50,3",2021-11-16,Montréal Canadiens,0,New York Rangers,0,0,0,0
"50,4",2021-11-16,Calgary Flames,0,Philadelphia Flyers,0,0,0,0
"50,5",2021-11-16,Buffalo Sabres,0,Pittsburgh Penguins,0,0,0,0
"50,6",2021-11-16,Arizona Coyotes,0,St. Louis Blues,0,0,0,0
"50,7",2021-11-16,San Jose Sharks,0,Minnesota Wild,0,0,0,0
"50,8",2021-11-16,Edmonton Oilers,0,Winnipeg Jets,0,0,0,0
"50,9",2021-11-16,Detroit Red Wings,0,Dallas Stars,0,0,1,0
"50,10",2021-11-16,Carolina Hurricanes,0,Vegas Golden Knights,0,0,0,0
"50,11",2021-11-16,Washington Capitals,0,Anaheim Ducks,0,0,0,0
"51,0",2021-11-17,Colorado Avalanche,0,Vancouver Canucks,0,0,0,0
"51,1",2021-11-17,Chicago Blackhawks,0,Seattle Kraken,0,0,0,0
"51,2",2021-11-17,Washington Capitals,0,Los Angeles Kings,0,0,1,0
"52,0",2021-11-18,Calgary Flames,0,Buffalo Sabres,0,0,0,0
"52,1",2021-11-18,New York Rangers,0,Toronto Maple Leafs,0,0,0,0
"52,2",2021-11-18,Pittsburgh Penguins,0,Montréal Canadiens,0,0,0,0
"52,3",2021-11-18,Nashville Predators,0,Ottawa Senators,0,0,0,0
"52,4",2021-11-18,New Jersey Devils,0,Florida Panthers,0,0,0,0
"52,5",2021-11-18,Tampa Bay Lightning,0,Philadelphia Flyers,0,0,0,0
"52,6",2021-11-18,San Jose Sharks,0,St. Louis Blues,0,0,0,0
"52,7",2021-11-18,Dallas Stars,0,Minnesota Wild,0,0,0,0
"52,8",2021-11-18,Winnipeg Jets,0,Edmonton Oilers,0,0,0,0
"52,9",2021-11-18,Columbus Blue Jackets,0,Arizona Coyotes,0,0,0,0
"52,10",2021-11-18,Detroit Red Wings,0,Vegas Golden Knights,0,0,0,0
"52,11",2021-11-18,Carolina Hurricanes,0,Anaheim Ducks,0,0,0,0
"53,0",2021-11-19,Winnipeg Jets,0,Vancouver Canucks,0,0,1,0
"53,1",2021-11-19,Colorado Avalanche,0,Seattle Kraken,0,0,0,0
"54,0",2021-11-20,New York Rangers,0,Ottawa Senators,0,0,0,0
"54,1",2021-11-20,New Jersey Devils,0,Tampa Bay Lightning,0,0,0,0
"54,2",2021-11-20,Carolina Hurricanes,0,Los Angeles Kings,0,0,0,0
"54,3",2021-11-20,Minnesota Wild,0,Florida Panthers,0,0,0,0
"54,4",2021-11-20,Pittsburgh Penguins,0,Toronto Maple Leafs,0,0,0,0
"54,5",2021-11-20,Nashville Predators,0,Montréal Canadiens,0,0,0,0
"54,6",2021-11-20,Calgary Flames,0,New York Islanders,0,0,0,0
"54,7",2021-11-20,Boston Bruins,0,Philadelphia Flyers,0,0,0,0
"54,8",2021-11-20,St. Louis Blues,0,Dallas Stars,0,0,0,0
"54,9",2021-11-20,Detroit Red Wings,0,Arizona Coyotes,0,0,0,0
"54,10",2021-11-20,Chicago Blackhawks,0,Edmonton Oilers,0,0,0,0
"54,11",2021-11-20,Columbus Blue Jackets,0,Vegas Golden Knights,0,0,0,0
"54,12",2021-11-20,Washington Capitals,0,San Jose Sharks,0,0,0,0
"55,0",2021-11-21,Minnesota Wild,0,Tampa Bay Lightning,0,0,1,1
"55,1",2021-11-21,Buffalo Sabres,0,New York Rangers,0,0,0,1
"55,2",2021-11-21,Calgary Flames,0,Boston Bruins,0,0,1,1
"55,3",2021-11-21,Toronto Maple Leafs,0,New York Islanders,0,0,1,1
"55,4",2021-11-21,Chicago Blackhawks,0,Vancouver Canucks,0,0,1,0
"55,5",2021-11-21,Washington Capitals,0,Seattle Kraken,0,0,1,0
"55,6",2021-11-21,Arizona Coyotes,0,Los Angeles Kings,0,0,1,1
"56,0",2021-11-22,Columbus Blue Jackets,0,Buffalo Sabres,0,0,0,1
"56,1",2021-11-22,Vegas Golden Knights,0,St. Louis Blues,0,0,0,0
"56,2",2021-11-22,Anaheim Ducks,0,Nashville Predators,0,0,0,0
"56,3",2021-11-22,Pittsburgh Penguins,0,Winnipeg Jets,0,0,0,0
"56,4",2021-11-22,Ottawa Senators,0,Colorado Avalanche,0,0,0,0
"56,5",2021-11-22,Carolina Hurricanes,0,San Jose Sharks,0,0,0,0
"57,0",2021-11-23,Philadelphia Flyers,0,Tampa Bay Lightning,0,0,0,0
"57,1",2021-11-23,Edmonton Oilers,0,Dallas Stars,0,0,0,0
"57,2",2021-11-23,Chicago Blackhawks,0,Calgary Flames,0,0,0,0
"58,0",2021-11-24,Boston Bruins,0,Buffalo Sabres,0,0,0,0
"58,1",2021-11-24,Philadelphia Flyers,0,Florida Panthers,0,0,1,0
"58,2",2021-11-24,Minnesota Wild,0,New Jersey Devils,0,0,0,0
"58,3",2021-11-24,Vancouver Canucks,0,Pittsburgh Penguins,0,0,0,0
"58,4",2021-11-24,Montréal Canadiens,0,Washington Capitals,0,0,0,0
"58,5",2021-11-24,Winnipeg Jets,0,Columbus Blue Jackets,0,0,0,0
"58,6",2021-11-24,St. Louis Blues,0,Detroit Red Wings,0,0,0,0
"58,7",2021-11-24,New York Rangers,0,New York Islanders,0,0,0,0
"58,8",2021-11-24,Vegas Golden Knights,0,Nashville Predators,0,0,0,0
"58,9",2021-11-24,Anaheim Ducks,0,Colorado Avalanche,0,0,0,0
"58,10",2021-11-24,Edmonton Oilers,0,Arizona Coyotes,0,0,1,0
"58,11",2021-11-24,Toronto Maple Leafs,0,Los Angeles Kings,0,0,0,0
"58,12",2021-11-24,Carolina Hurricanes,0,Seattle Kraken,0,0,0,0
"58,13",2021-11-24,Ottawa Senators,0,San Jose Sharks,0,0,0,0
"59,0",2021-11-26,St. Louis Blues,0,Chicago Blackhawks,0,0,0,0
"59,1",2021-11-26,New York Rangers,0,Boston Bruins,0,0,0,0
"59,2",2021-11-26,Carolina Hurricanes,0,Philadelphia Flyers,0,0,0,0
"59,3",2021-11-26,Winnipeg Jets,0,Minnesota Wild,0,0,0,0
"59,4",2021-11-26,Ottawa Senators,0,Anaheim Ducks,0,0,0,0
"59,5",2021-11-26,Florida Panthers,0,Washington Capitals,0,0,0,0
"59,6",2021-11-26,New Jersey Devils,0,Nashville Predators,0,0,0,0
"59,7",2021-11-26,Montréal Canadiens,0,Buffalo Sabres,0,0,0,0
"59,8",2021-11-26,Seattle Kraken,0,Tampa Bay Lightning,0,0,0,0
"59,9",2021-11-26,Vancouver Canucks,0,Columbus Blue Jackets,0,0,0,0
"59,10",2021-11-26,Pittsburgh Penguins,0,New York Islanders,0,0,0,0
"59,11",2021-11-26,Colorado Avalanche,0,Dallas Stars,0,0,0,0
"59,12",2021-11-26,Toronto Maple Leafs,0,San Jose Sharks,0,0,0,0
"60,0",2021-11-27,Seattle Kraken,0,Florida Panthers,0,0,1,1
"60,1",2021-11-27,Buffalo Sabres,0,Detroit Red Wings,0,0,1,0
"60,2",2021-11-27,Montréal Canadiens,0,Pittsburgh Penguins,0,0,1,1
"60,3",2021-11-27,Edmonton Oilers,0,Vegas Golden Knights,0,0,0,0
"60,4",2021-11-27,Ottawa Senators,0,Los Angeles Kings,0,0,1,0
"60,5",2021-11-27,Columbus Blue Jackets,0,St. Louis Blues,0,0,1,1
"60,6",2021-11-27,Dallas Stars,0,Arizona Coyotes,0,0,1,0
"60,7",2021-11-27,Nashville Predators,0,Colorado Avalanche,0,0,1,1
"60,8",2021-11-27,Winnipeg Jets,0,Calgary Flames,0,0,1,0
"61,0",2021-11-28,Washington Capitals,0,Carolina Hurricanes,0,0,0,0
"61,1",2021-11-28,Tampa Bay Lightning,0,Minnesota Wild,0,0,0,0
"61,2",2021-11-28,New York Islanders,0,New York Rangers,0,0,0,0
"61,3",2021-11-28,Vancouver Canucks,0,Boston Bruins,0,0,0,0
"61,4",2021-11-28,Philadelphia Flyers,0,New Jersey Devils,0,0,0,0
"61,5",2021-11-28,San Jose Sharks,0,Chicago Blackhawks,0,0,0,0
"61,6",2021-11-28,Toronto Maple Leafs,0,Anaheim Ducks,0,0,0,0
"62,0",2021-11-29,Seattle Kraken,0,Buffalo Sabres,0,0,0,0
"62,1",2021-11-29,Vancouver Canucks,0,Montréal Canadiens,0,0,1,0
"62,2",2021-11-29,Arizona Coyotes,0,Winnipeg Jets,0,0,0,0
"62,3",2021-11-29,Pittsburgh Penguins,0,Calgary Flames,0,0,0,0
"63,0",2021-11-30,Detroit Red Wings,0,Boston Bruins,0,0,0,0
"63,1",2021-11-30,Washington Capitals,0,Florida Panthers,0,0,0,0
"63,2",2021-11-30,San Jose Sharks,0,New Jersey Devils,0,0,0,0
"63,3",2021-11-30,New York Islanders,0,Philadelphia Flyers,0,0,0,0
"63,4",2021-11-30,Tampa Bay Lightning,0,St. Louis Blues,0,0,0,0
"63,5",2021-11-30,Columbus Blue Jackets,0,Nashville Predators,0,0,0,0
"63,6",2021-11-30,Arizona Coyotes,0,Minnesota Wild,0,0,1,0
"63,7",2021-11-30,Carolina Hurricanes,0,Dallas Stars,0,0,0,0
"63,8",2021-11-30,Anaheim Ducks,0,Los Angeles Kings,0,0,0,0
"64,0",2021-12-01,Philadelphia Flyers,0,New York Rangers,0,0,1,0
"64,1",2021-12-01,Colorado Avalanche,0,Toronto Maple Leafs,0,0,0,0
"64,2",2021-12-01,Vancouver Canucks,0,Ottawa Senators,0,0,0,0
"64,3",2021-12-01,Seattle Kraken,0,Detroit Red Wings,0,0,0,1
"64,4",2021-12-01,Pittsburgh Penguins,0,Edmonton Oilers,0,0,0,0
"64,5",2021-12-01,Vegas Golden Knights,0,Anaheim Ducks,0,0,0,1
"65,0",2021-12-02,Colorado Avalanche,0,Montréal Canadiens,0,0,1,0
"65,1",2021-12-02,St. Louis Blues,0,Tampa Bay Lightning,0,0,0,0
"65,2",2021-12-02,Buffalo Sabres,0,Florida Panthers,0,0,0,0
"65,3",2021-12-02,Chicago Blackhawks,0,Washington Capitals,0,0,0,0
"65,4",2021-12-02,Ottawa Senators,0,Carolina Hurricanes,0,0,1,0
"65,5",2021-12-02,San Jose Sharks,0,New York Islanders,0,0,0,0
"65,6",2021-12-02,Boston Bruins,0,Nashville Predators,0,0,0,0
"65,7",2021-12-02,New Jersey Devils,0,Minnesota Wild,0,0,0,0
"65,8",2021-12-02,Columbus Blue Jackets,0,Dallas Stars,0,0,0,0
"65,9",2021-12-02,Calgary Flames,0,Los Angeles Kings,0,0,0,0
"66,0",2021-12-03,San Jose Sharks,0,New York Rangers,0,0,1,0
"66,1",2021-12-03,New Jersey Devils,0,Winnipeg Jets,0,0,1,0
"66,2",2021-12-03,Vegas Golden Knights,0,Arizona Coyotes,0,0,0,0
"66,3",2021-12-03,Calgary Flames,0,Anaheim Ducks,0,0,1,0
"66,4",2021-12-03,Edmonton Oilers,0,Seattle Kraken,0,0,0,0
"67,0",2021-12-04,St. Louis Blues,0,Florida Panthers,0,0,0,0
"67,1",2021-12-04,Tampa Bay Lightning,0,Boston Bruins,0,0,0,0
"67,2",2021-12-04,Colorado Avalanche,0,Ottawa Senators,0,0,0,0
"67,3",2021-12-04,New York Islanders,0,Detroit Red Wings,0,0,0,0
"67,4",2021-12-04,Columbus Blue Jackets,0,Washington Capitals,0,0,0,0
"67,5",2021-12-04,Buffalo Sabres,0,Carolina Hurricanes,0,0,0,0
"67,6",2021-12-04,Montréal Canadiens,0,Nashville Predators,0,0,0,0
"67,7",2021-12-04,Toronto Maple Leafs,0,Minnesota Wild,0,0,0,0
"67,8",2021-12-04,Chicago Blackhawks,0,New York Rangers,0,0,0,1
"67,9",2021-12-04,Pittsburgh Penguins,0,Vancouver Canucks,0,0,0,0
"68,0",2021-12-05,Tampa Bay Lightning,0,Philadelphia Flyers,0,0,1,0
"68,1",2021-12-05,San Jose Sharks,0,Columbus Blue Jackets,0,0,0,1
"68,2",2021-12-05,Toronto Maple Leafs,0,Winnipeg Jets,0,0,1,0
"68,3",2021-12-05,Chicago Blackhawks,0,New York Islanders,0,0,1,1
"68,4",2021-12-05,Los Angeles Kings,0,Edmonton Oilers,0,0,0,0
"68,5",2021-12-05,Calgary Flames,0,Vegas Golden Knights,0,0,0,0
"69,0",2021-12-06,Colorado Avalanche,0,Philadelphia Flyers,0,0,0,1
"69,1",2021-12-06,Anaheim Ducks,0,Washington Capitals,0,0,0,0
"69,2",2021-12-06,Arizona Coyotes,0,Dallas Stars,0,0,0,0
"69,3",2021-12-06,Los Angeles Kings,0,Vancouver Canucks,0,0,1,0
"69,4",2021-12-06,Pittsburgh Penguins,0,Seattle Kraken,0,0,0,0
"70,0",2021-12-07,Columbus Blue Jackets,0,Toronto Maple Leafs,0,0,0,0
"70,1",2021-12-07,Tampa Bay Lightning,0,Montréal Canadiens,0,0,0,0
"70,2",2021-12-07,New York Islanders,0,Ottawa Senators,0,0,0,0
"70,3",2021-12-07,Nashville Predators,0,Detroit Red Wings,0,0,0,0
"70,4",2021-12-07,Anaheim Ducks,0,Buffalo Sabres,0,0,1,0
"70,5",2021-12-07,Florida Panthers,0,St. Louis Blues,0,0,0,0
"70,6",2021-12-07,Carolina Hurricanes,0,Winnipeg Jets,0,0,0,0
"70,7",2021-12-07,New York Rangers,0,Chicago Blackhawks,0,0,0,0
"70,8",2021-12-07,Minnesota Wild,0,Edmonton Oilers,0,0,0,0
"70,9",2021-12-07,Calgary Flames,0,San Jose Sharks,0,0,0,0
"71,0",2021-12-08,Philadelphia Flyers,0,New Jersey Devils,0,0,0,0
"71,1",2021-12-08,Colorado Avalanche,0,New York Rangers,0,0,0,1
"71,2",2021-12-08,Boston Bruins,0,Vancouver Canucks,0,0,0,0
"71,3",2021-12-08,Dallas Stars,0,Vegas Golden Knights,0,0,0,0
"72,0",2021-12-09,Tampa Bay Lightning,0,Toronto Maple Leafs,0,0,0,0
"72,1",2021-12-09,Chicago Blackhawks,0,Montréal Canadiens,0,0,0,0
"72,2",2021-12-09,Anaheim Ducks,0,Columbus Blue Jackets,0,0,0,0
"72,3",2021-12-09,Nashville Predators,0,New York Islanders,0,0,0,0
"72,4",2021-12-09,Detroit Red Wings,0,St. Louis Blues,0,0,0,0
"72,5",2021-12-09,Carolina Hurricanes,0,Calgary Flames,0,0,0,0
"72,6",2021-12-09,Boston Bruins,0,Edmonton Oilers,0,0,1,0
"72,7",2021-12-09,Winnipeg Jets,0,Seattle Kraken,0,0,0,0
"72,8",2021-12-09,Dallas Stars,0,Los Angeles Kings,0,0,1,0
"72,9",2021-12-09,Minnesota Wild,0,San Jose Sharks,0,0,0,0
"73,0",2021-12-10,New York Rangers,0,Buffalo Sabres,0,0,0,0
"73,1",2021-12-10,Pittsburgh Penguins,0,Washington Capitals,0,0,0,0
"73,2",2021-12-10,Nashville Predators,0,New Jersey Devils,0,0,1,0
"73,3",2021-12-10,Detroit Red Wings,0,Colorado Avalanche,0,0,1,0
"73,4",2021-12-10,Florida Panthers,0,Arizona Coyotes,0,0,0,0
"73,5",2021-12-10,Winnipeg Jets,0,Vancouver Canucks,0,0,1,0
"73,6",2021-12-10,Philadelphia Flyers,0,Vegas Golden Knights,0,0,0,0
"74,0",2021-12-11,Tampa Bay Lightning,0,Ottawa Senators,0,0,0,0
"74,1",2021-12-11,Washington Capitals,0,Buffalo Sabres,0,0,1,1
"74,2",2021-12-11,Chicago Blackhawks,0,Toronto Maple Leafs,0,0,0,0
"74,3",2021-12-11,Anaheim Ducks,0,Pittsburgh Penguins,0,0,0,1
"74,4",2021-12-11,Montréal Canadiens,0,St. Louis Blues,0,0,0,0
"74,5",2021-12-11,New Jersey Devils,0,New York Islanders,0,0,1,0
"74,6",2021-12-11,Philadelphia Flyers,0,Arizona Coyotes,0,0,1,1
"74,7",2021-12-11,Boston Bruins,0,Calgary Flames,0,0,0,0
"74,8",2021-12-11,Carolina Hurricanes,0,Edmonton Oilers,0,0,0,0
"74,9",2021-12-11,Columbus Blue Jackets,0,Seattle Kraken,0,0,0,0
"74,10",2021-12-11,Minnesota Wild,0,Los Angeles Kings,0,0,0,0
"74,11",2021-12-11,Dallas Stars,0,San Jose Sharks,0,0,0,0
"75,0",2021-12-12,Nashville Predators,0,New York Rangers,0,0,0,0
"75,1",2021-12-12,Anaheim Ducks,0,St. Louis Blues,0,0,1,1
"75,2",2021-12-12,Florida Panthers,0,Colorado Avalanche,0,0,0,0
"75,3",2021-12-12,Minnesota Wild,0,Vegas Golden Knights,0,0,1,0
"75,4",2021-12-12,Carolina Hurricanes,0,Vancouver Canucks,0,0,1,0
"76,0",2021-12-13,Calgary Flames,0,Chicago Blackhawks,0,0,0,0
"77,0",2021-12-14,Vegas Golden Knights,0,Boston Bruins,0,0,0,0
"77,1",2021-12-14,Los Angeles Kings,0,Tampa Bay Lightning,0,0,0,0
"77,2",2021-12-14,Ottawa Senators,0,Florida Panthers,0,0,0,0
"77,3",2021-12-14,New Jersey Devils,0,Philadelphia Flyers,0,0,0,0
"77,4",2021-12-14,Montréal Canadiens,0,Pittsburgh Penguins,0,0,0,0
"77,5",2021-12-14,New York Islanders,0,Detroit Red Wings,0,0,0,0
"77,6",2021-12-14,Calgary Flames,0,Nashville Predators,0,0,1,0
"77,7",2021-12-14,Carolina Hurricanes,0,Minnesota Wild,0,0,0,0
"77,8",2021-12-14,Buffalo Sabres,0,Winnipeg Jets,0,0,0,0
"77,9",2021-12-14,St. Louis Blues,0,Dallas Stars,0,0,0,0
"77,10",2021-12-14,New York Rangers,0,Colorado Avalanche,0,0,0,0
"77,11",2021-12-14,Toronto Maple Leafs,0,Edmonton Oilers,0,0,0,0
"77,12",2021-12-14,Columbus Blue Jackets,0,Vancouver Canucks,0,0,0,0
"77,13",2021-12-14,Seattle Kraken,0,San Jose Sharks,0,0,0,0
"78,0",2021-12-15,Washington Capitals,0,Chicago Blackhawks,0,0,0,0
"78,1",2021-12-15,New York Rangers,0,Arizona Coyotes,0,0,1,0
"78,2",2021-12-15,Seattle Kraken,0,Anaheim Ducks,0,0,1,0
"79,0",2021-12-16,Philadelphia Flyers,0,Montréal Canadiens,0,0,0,0
"79,1",2021-12-16,Ottawa Senators,0,Tampa Bay Lightning,0,0,0,0
"79,2",2021-12-16,Los Angeles Kings,0,Florida Panthers,0,0,0,0
"79,3",2021-12-16,Vegas Golden Knights,0,New Jersey Devils,0,0,0,0
"79,4",2021-12-16,Detroit Red Wings,0,Carolina Hurricanes,0,0,0,0
"79,5",2021-12-16,Boston Bruins,0,New York Islanders,0,0,0,0
"79,6",2021-12-16,Colorado Avalanche,0,Nashville Predators,0,0,0,0
"79,7",2021-12-16,Buffalo Sabres,0,Minnesota Wild,0,0,0,0
"79,8",2021-12-16,Toronto Maple Leafs,0,Calgary Flames,0,0,0,0
"79,9",2021-12-16,Columbus Blue Jackets,0,Edmonton Oilers,0,0,0,0
"79,10",2021-12-16,Vancouver Canucks,0,San Jose Sharks,0,0,0,0
"80,0",2021-12-17,Vegas Golden Knights,0,New York Rangers,0,0,1,0
"80,1",2021-12-17,Buffalo Sabres,0,Pittsburgh Penguins,0,0,1,0
"80,2",2021-12-17,Dallas Stars,0,St. Louis Blues,0,0,0,0
"80,3",2021-12-17,Washington Capitals,0,Winnipeg Jets,0,0,0,0
"80,4",2021-12-17,Nashville Predators,0,Chicago Blackhawks,0,0,1,0
"80,5",2021-12-17,Arizona Coyotes,0,Anaheim Ducks,0,0,0,0
"81,0",2021-12-18,Florida Panthers,0,Minnesota Wild,0,0,0,0
"81,1",2021-12-18,Boston Bruins,0,Montréal Canadiens,0,0,0,0
"81,2",2021-12-18,Ottawa Senators,0,Philadelphia Flyers,0,0,0,0
"81,3",2021-12-18,Los Angeles Kings,0,Carolina Hurricanes,0,0,0,0
"81,4",2021-12-18,Toronto Maple Leafs,0,Vancouver Canucks,0,0,0,0
"81,5",2021-12-18,New Jersey Devils,0,Detroit Red Wings,0,0,0,0
"81,6",2021-12-18,Chicago Blackhawks,0,Dallas Stars,0,0,1,1
"81,7",2021-12-18,Tampa Bay Lightning,0,Colorado Avalanche,0,0,0,0
"81,8",2021-12-18,Columbus Blue Jackets,0,Calgary Flames,0,0,0,0
"81,9",2021-12-18,Edmonton Oilers,0,Seattle Kraken,0,0,0,0
"82,0",2021-12-19,Vegas Golden Knights,0,New York Islanders,0,0,0,0
"82,1",2021-12-19,St. Louis Blues,0,Winnipeg Jets,0,0,0,0
"82,2",2021-12-19,Boston Bruins,0,Ottawa Senators,0,0,1,1
"82,3",2021-12-19,Nashville Predators,0,Carolina Hurricanes,0,0,0,1
"82,4",2021-12-19,Pittsburgh Penguins,0,New Jersey Devils,0,0,0,1
"82,5",2021-12-19,Los Angeles Kings,0,Washington Capitals,0,0,1,0
"82,6",2021-12-19,Toronto Maple Leafs,0,Seattle Kraken,0,0,1,1
"82,7",2021-12-19,Arizona Coyotes,0,Vancouver Canucks,0,0,0,1
"83,0",2021-12-20,Columbus Blue Jackets,0,Buffalo Sabres,0,0,0,0
"83,1",2021-12-20,Montréal Canadiens,0,New York Islanders,0,0,0,1
"83,2",2021-12-20,Colorado Avalanche,0,Detroit Red Wings,0,0,0,0
"83,3",2021-12-20,Minnesota Wild,0,Dallas Stars,0,0,0,0
"83,4",2021-12-20,Anaheim Ducks,0,Edmonton Oilers,0,0,0,0
"84,0",2021-12-21,Carolina Hurricanes,0,Boston Bruins,0,0,0,0
"84,1",2021-12-21,St. Louis Blues,0,Ottawa Senators,0,0,0,0
"84,2",2021-12-21,Washington Capitals,0,Philadelphia Flyers,0,0,0,0
"84,3",2021-12-21,New Jersey Devils,0,Pittsburgh Penguins,0,0,0,0
"84,4",2021-12-21,Winnipeg Jets,0,Nashville Predators,0,0,0,0
"84,5",2021-12-21,Florida Panthers,0,Chicago Blackhawks,0,0,0,0
"84,6",2021-12-21,Anaheim Ducks,0,Calgary Flames,0,0,1,0
"84,7",2021-12-21,Tampa Bay Lightning,0,Vegas Golden Knights,0,0,0,0
"84,8",2021-12-21,Arizona Coyotes,0,Seattle Kraken,0,0,0,0
"84,9",2021-12-21,Vancouver Canucks,0,San Jose Sharks,0,0,0,0
"85,0",2021-12-22,Colorado Avalanche,0,Buffalo Sabres,0,0,0,0
"85,1",2021-12-22,Montréal Canadiens,0,New York Rangers,0,0,0,0
"85,2",2021-12-22,Winnipeg Jets,0,Dallas Stars,0,0,1,0
"85,3",2021-12-22,Edmonton Oilers,0,Los Angeles Kings,0,0,0,0
"86,0",2021-12-23,St. Louis Blues,0,Toronto Maple Leafs,0,0,0,0
"86,1",2021-12-23,Colorado Avalanche,0,Boston Bruins,0,0,1,0
"86,2",2021-12-23,Carolina Hurricanes,0,Ottawa Senators,0,0,0,0
"86,3",2021-12-23,Nashville Predators,0,Florida Panthers,0,0,0,0
"86,4",2021-12-23,Montréal Canadiens,0,New Jersey Devils,0,0,1,0
"86,5",2021-12-23,Philadelphia Flyers,0,Pittsburgh Penguins,0,0,0,0
"86,6",2021-12-23,Buffalo Sabres,0,Columbus Blue Jackets,0,0,1,0
"86,7",2021-12-23,Washington Capitals,0,New York Islanders,0,0,0,0
"86,8",2021-12-23,Detroit Red Wings,0,Minnesota Wild,0,0,0,0
"86,9",2021-12-23,Dallas Stars,0,Chicago Blackhawks,0,0,1,0
"86,10",2021-12-23,Seattle Kraken,0,Calgary Flames,0,0,0,0
"86,11",2021-12-23,Tampa Bay Lightning,0,Arizona Coyotes,0,0,0,0
"86,12",2021-12-23,Anaheim Ducks,0,Vancouver Canucks,0,0,0,0
"86,13",2021-12-23,Los Angeles Kings,0,Vegas Golden Knights,0,0,1,0
"86,14",2021-12-23,Edmonton Oilers,0,San Jose Sharks,0,0,1,0
"87,0",2021-12-27,Pittsburgh Penguins,0,Boston Bruins,0,0,0,0
"87,1",2021-12-27,New York Islanders,0,Buffalo Sabres,0,0,0,0
"87,2",2021-12-27,Detroit Red Wings,0,New York Rangers,0,0,0,0
"87,3",2021-12-27,Ottawa Senators,0,Washington Capitals,0,0,0,0
"87,4",2021-12-27,Florida Panthers,0,Carolina Hurricanes,0,0,0,0
"87,5",2021-12-27,Toronto Maple Leafs,0,Columbus Blue Jackets,0,0,0,0
"87,6",2021-12-27,New Jersey Devils,0,St. Louis Blues,0,0,0,0
"87,7",2021-12-27,Nashville Predators,0,Dallas Stars,0,0,0,0
"87,8",2021-12-27,Minnesota Wild,0,Winnipeg Jets,0,0,0,0
"87,9",2021-12-27,Los Angeles Kings,0,Arizona Coyotes,0,0,0,0
"87,10",2021-12-27,Edmonton Oilers,0,Calgary Flames,0,0,0,0
"87,11",2021-12-27,Seattle Kraken,0,Vancouver Canucks,0,0,0,0
"87,12",2021-12-27,Colorado Avalanche,0,Vegas Golden Knights,0,0,0,0
"87,13",2021-12-27,San Jose Sharks,0,Anaheim Ducks,0,0,0,0
"88,0",2021-12-28,Montréal Canadiens,0,Tampa Bay Lightning,0,0,0,0
"88,1",2021-12-28,Columbus Blue Jackets,0,Chicago Blackhawks,0,0,1,0
"88,2",2021-12-28,Vegas Golden Knights,0,Los Angeles Kings,0,0,1,1
"88,3",2021-12-28,Arizona Coyotes,0,San Jose Sharks,0,0,1,1
"89,0",2021-12-29,New Jersey Devils,0,Buffalo Sabres,0,0,0,0
"89,1",2021-12-29,New York Rangers,0,Florida Panthers,0,0,0,0
"89,2",2021-12-29,Nashville Predators,0,Washington Capitals,0,0,0,0
"89,3",2021-12-29,Pittsburgh Penguins,0,Toronto Maple Leafs,0,0,0,0
"89,4",2021-12-29,Boston Bruins,0,Ottawa Senators,0,0,0,0
"89,5",2021-12-29,Detroit Red Wings,0,New York Islanders,0,0,0,0
"89,6",2021-12-29,Chicago Blackhawks,0,Winnipeg Jets,0,0,1,0
"89,7",2021-12-29,Edmonton Oilers,0,St. Louis Blues,0,0,0,0
"89,8",2021-12-29,Dallas Stars,0,Colorado Avalanche,0,0,0,0
"89,9",2021-12-29,Philadelphia Flyers,0,Seattle Kraken,0,0,0,0
"89,10",2021-12-29,Vancouver Canucks,0,Anaheim Ducks,0,0,0,0
"90,0",2021-12-30,Tampa Bay Lightning,0,Florida Panthers,0,0,0,1
"90,1",2021-12-30,Montréal Canadiens,0,Carolina Hurricanes,0,0,0,0
"90,2",2021-12-30,Nashville Predators,0,Columbus Blue Jackets,0,0,1,0
"90,3",2021-12-30,Buffalo Sabres,0,New York Islanders,0,0,1,1
"90,4",2021-12-30,Calgary Flames,0,Seattle Kraken,0,0,0,1
"90,5",2021-12-30,Vancouver Canucks,0,Los Angeles Kings,0,0,1,0
"90,6",2021-12-30,Philadelphia Flyers,0,San Jose Sharks,0,0,1,0
"91,0",2021-12-31,Pittsburgh Penguins,0,Ottawa Senators,0,0,0,0
"91,1",2021-12-31,Edmonton Oilers,0,New Jersey Devils,0,0,0,0
"91,2",2021-12-31,Anaheim Ducks,0,Vegas Golden Knights,0,0,0,0
"91,3",2021-12-31,New York Rangers,0,Tampa Bay Lightning,0,0,0,1
"91,4",2021-12-31,Washington Capitals,0,Detroit Red Wings,0,0,0,0
"91,5",2021-12-31,Colorado Avalanche,0,Dallas Stars,0,0,0,0
"91,6",2021-12-31,Winnipeg Jets,0,Calgary Flames,0,0,0,1
"92,0",2022-01-01,Buffalo Sabres,0,Boston Bruins,0,0,0,0
"92,1",2022-01-01,Montréal Canadiens,0,Florida Panthers,0,0,0,0
"92,2",2022-01-01,Carolina Hurricanes,0,Columbus Blue Jackets,0,0,0,0
"92,3",2022-01-01,Edmonton Oilers,0,New York Islanders,0,0,1,0
"92,4",2022-01-01,Chicago Blackhawks,0,Nashville Predators,0,0,0,0
"92,5",2022-01-01,Ottawa Senators,0,Toronto Maple Leafs,0,0,1,0
"92,6",2022-01-01,St. Louis Blues,0,Minnesota Wild,0,0,0,0
"92,7",2022-01-01,Vancouver Canucks,0,Seattle Kraken,0,0,0,0
"92,8",2022-01-01,Philadelphia Flyers,0,Los Angeles Kings,0,0,0,0
"93,0",2022-01-02,Tampa Bay Lightning,0,New York Rangers,0,0,0,0
"93,1",2022-01-02,Boston Bruins,0,Detroit Red Wings,0,0,1,0
"93,2",2022-01-02,San Jose Sharks,0,Pittsburgh Penguins,0,0,0,0
"93,3",2022-01-02,New Jersey Devils,0,Washington Capitals,0,0,0,0
"93,4",2022-01-02,Anaheim Ducks,0,Colorado Avalanche,0,0,0,0
"93,5",2022-01-02,Winnipeg Jets,0,Vegas Golden Knights,0,0,0,0
"93,6",2022-01-02,Calgary Flames,0,Chicago Blackhawks,0,0,0,1
"93,7",2022-01-02,Dallas Stars,0,Arizona Coyotes,0,0,0,0
"94,0",2022-01-03,Edmonton Oilers,0,New York Rangers,0,0,0,1
"94,1",2022-01-03,Carolina Hurricanes,0,Toronto Maple Leafs,0,0,0,0
"94,2",2022-01-03,Minnesota Wild,0,Ottawa Senators,0,0,0,0
"95,0",2022-01-04,New Jersey Devils,0,Boston Bruins,0,0,0,0
"95,1",2022-01-04,Washington Capitals,0,Montréal Canadiens,0,0,0,0
"95,2",2022-01-04,Calgary Flames,0,Florida Panthers,0,0,0,0
"95,3",2022-01-04,Tampa Bay Lightning,0,Columbus Blue Jackets,0,0,0,0
"95,4",2022-01-04,San Jose Sharks,0,Detroit Red Wings,0,0,0,0
"95,5",2022-01-04,Colorado Avalanche,0,Chicago Blackhawks,0,0,0,0
"95,6",2022-01-04,Winnipeg Jets,0,Arizona Coyotes,0,0,0,0
"95,7",2022-01-04,Nashville Predators,0,Vegas Golden Knights,0,0,0,0
"95,8",2022-01-04,Philadelphia Flyers,0,Anaheim Ducks,0,0,0,0
"95,9",2022-01-04,New York Islanders,0,Seattle Kraken,0,0,0,0
"96,0",2022-01-05,Edmonton Oilers,0,Toronto Maple Leafs,0,0,0,0
"96,1",2022-01-05,St. Louis Blues,0,Pittsburgh Penguins,0,0,0,0
"96,2",2022-01-05,New York Islanders,0,Vancouver Canucks,0,0,1,0
"97,0",2022-01-06,Minnesota Wild,0,Boston Bruins,0,0,0,0
"97,1",2022-01-06,San Jose Sharks,0,Buffalo Sabres,0,0,0,0
"97,2",2022-01-06,Toronto Maple Leafs,0,Montréal Canadiens,0,0,1,0
"97,3",2022-01-06,Calgary Flames,0,Tampa Bay Lightning,0,0,0,0
"97,4",2022-01-06,Columbus Blue Jackets,0,New Jersey Devils,0,0,0,0
"97,5",2022-01-06,Pittsburgh Penguins,0,Philadelphia Flyers,0,0,1,0
"97,6",2022-01-06,Florida Panthers,0,Dallas Stars,0,0,0,0
"97,7",2022-01-06,Winnipeg Jets,0,Colorado Avalanche,0,0,0,0
"97,8",2022-01-06,Chicago Blackhawks,0,Arizona Coyotes,0,0,0,0
"97,9",2022-01-06,New York Rangers,0,Vegas Golden Knights,0,0,0,0
"97,10",2022-01-06,Detroit Red Wings,0,Anaheim Ducks,0,0,0,0
"97,11",2022-01-06,Ottawa Senators,0,Seattle Kraken,0,0,0,0
"97,12",2022-01-06,Nashville Predators,0,Los Angeles Kings,0,0,0,0
"98,0",2022-01-07,Calgary Flames,0,Carolina Hurricanes,0,0,1,0
"98,1",2022-01-07,Washington Capitals,0,St. Louis Blues,0,0,0,0
"99,0",2022-01-08,Pittsburgh Penguins,0,Dallas Stars,0,0,0,0
"99,1",2022-01-08,Buffalo Sabres,0,Montréal Canadiens,0,0,0,0
"99,2",2022-01-08,Boston Bruins,0,Tampa Bay Lightning,0,0,0,0
"99,3",2022-01-08,San Jose Sharks,0,Philadelphia Flyers,0,0,0,0
"99,4",2022-01-08,Florida Panthers,0,Carolina Hurricanes,0,0,0,1
"99,5",2022-01-08,New Jersey Devils,0,Columbus Blue Jackets,0,0,0,0
"99,6",2022-01-08,Seattle Kraken,0,Winnipeg Jets,0,0,0,0
"99,7",2022-01-08,Toronto Maple Leafs,0,Colorado Avalanche,0,0,0,0
"99,8",2022-01-08,Washington Capitals,0,Minnesota Wild,0,0,1,0
"99,9",2022-01-08,Nashville Predators,0,Arizona Coyotes,0,0,0,0
"99,10",2022-01-08,New York Islanders,0,Edmonton Oilers,0,0,0,0
"99,11",2022-01-08,Ottawa Senators,0,Vancouver Canucks,0,0,0,0
"99,12",2022-01-08,Chicago Blackhawks,0,Vegas Golden Knights,0,0,0,0
"99,13",2022-01-08,New York Rangers,0,Anaheim Ducks,0,0,0,0
"99,14",2022-01-08,Detroit Red Wings,0,Los Angeles Kings,0,0,0,0
"100,0",2022-01-09,Dallas Stars,0,St. Louis Blues,0,0,1,0
"101,0",2022-01-10,Columbus Blue Jackets,0,Montréal Canadiens,0,0,0,0
"101,1",2022-01-10,Tampa Bay Lightning,0,New Jersey Devils,0,0,0,0
"101,2",2022-01-10,Boston Bruins,0,Washington Capitals,0,0,0,0
"101,3",2022-01-10,Minnesota Wild,0,Winnipeg Jets,0,0,0,0
"101,4",2022-01-10,Seattle Kraken,0,Colorado Avalanche,0,0,0,0
"101,5",2022-01-10,Ottawa Senators,0,Edmonton Oilers,0,0,0,0
"101,6",2022-01-10,New York Rangers,0,Los Angeles Kings,0,0,0,0
"102,0",2022-01-11,Tampa Bay Lightning,0,Buffalo Sabres,0,0,1,0
"102,1",2022-01-11,Vancouver Canucks,0,Florida Panthers,0,0,0,0
"102,2",2022-01-11,Carolina Hurricanes,0,Philadelphia Flyers,0,0,0,0
"102,3",2022-01-11,Chicago Blackhawks,0,Columbus Blue Jackets,0,0,0,1
"102,4",2022-01-11,Colorado Avalanche,0,Nashville Predators,0,0,1,0
"102,5",2022-01-11,New York Islanders,0,Calgary Flames,0,0,0,0
"102,6",2022-01-11,Toronto Maple Leafs,0,Vegas Golden Knights,0,0,0,0
"102,7",2022-01-11,Pittsburgh Penguins,0,Anaheim Ducks,0,0,0,0
"102,8",2022-01-11,Detroit Red Wings,0,San Jose Sharks,0,0,0,0
"103,0",2022-01-12,Boston Bruins,0,Montréal Canadiens,0,0,0,0
"103,1",2022-01-12,Seattle Kraken,0,Dallas Stars,0,0,0,0
"103,2",2022-01-12,Minnesota Wild,0,Edmonton Oilers,0,0,0,0
"103,3",2022-01-12,Toronto Maple Leafs,0,Arizona Coyotes,0,0,1,0
"104,0",2022-01-13,Philadelphia Flyers,0,Boston Bruins,0,0,0,1
"104,1",2022-01-13,Vancouver Canucks,0,Tampa Bay Lightning,0,0,0,0
"104,2",2022-01-13,Columbus Blue Jackets,0,Carolina Hurricanes,0,0,0,0
"104,3",2022-01-13,Winnipeg Jets,0,Detroit Red Wings,0,0,0,0
"104,4",2022-01-13,New Jersey Devils,0,New York Islanders,0,0,0,0
"104,5",2022-01-13,Seattle Kraken,0,St. Louis Blues,0,0,1,0
"104,6",2022-01-13,Buffalo Sabres,0,Nashville Predators,0,0,0,0
"104,7",2022-01-13,Montréal Canadiens,0,Chicago Blackhawks,0,0,1,0
"104,8",2022-01-13,Ottawa Senators,0,Calgary Flames,0,0,0,0
"104,9",2022-01-13,Pittsburgh Penguins,0,Los Angeles Kings,0,0,0,0
"104,10",2022-01-13,New York Rangers,0,San Jose Sharks,0,0,0,0
"105,0",2022-01-14,Dallas Stars,0,Florida Panthers,0,0,0,0
"105,1",2022-01-14,Anaheim Ducks,0,Minnesota Wild,0,0,0,0
"105,2",2022-01-14,Arizona Coyotes,0,Colorado Avalanche,0,0,0,0
"105,3",2022-01-14,Vegas Golden Knights,0,Edmonton Oilers,0,0,0,0
"106,0",2022-01-15,Nashville Predators,0,Boston Bruins,0,0,0,0
"106,1",2022-01-15,New Jersey Devils,0,Montréal Canadiens,0,0,0,0
"106,2",2022-01-15,Vancouver Canucks,0,Carolina Hurricanes,0,0,0,0
"106,3",2022-01-15,Washington Capitals,0,New York Islanders,0,0,0,0
"106,4",2022-01-15,Columbus Blue Jackets,0,Florida Panthers,0,0,0,1
"106,5",2022-01-15,Buffalo Sabres,0,Detroit Red Wings,0,0,0,0
"106,6",2022-01-15,Dallas Stars,0,Tampa Bay Lightning,0,0,1,0
"106,7",2022-01-15,New York Rangers,0,Philadelphia Flyers,0,0,0,0
"106,8",2022-01-15,Toronto Maple Leafs,0,St. Louis Blues,0,0,0,0
"106,9",2022-01-15,Ottawa Senators,0,Winnipeg Jets,0,0,0,0
"106,10",2022-01-15,Anaheim Ducks,0,Chicago Blackhawks,0,0,1,0
"106,11",2022-01-15,Colorado Avalanche,0,Arizona Coyotes,0,0,1,1
"106,12",2022-01-15,Vegas Golden Knights,0,Calgary Flames,0,0,1,0
"106,13",2022-01-15,Los Angeles Kings,0,Seattle Kraken,0,0,0,0
"106,14",2022-01-15,Pittsburgh Penguins,0,San Jose Sharks,0,0,0,0
"107,0",2022-01-16,Vancouver Canucks,0,Washington Capitals,0,0,1,1
"107,1",2022-01-16,Edmonton Oilers,0,Winnipeg Jets,0,0,0,1
"108,0",2022-01-17,Detroit Red Wings,0,Buffalo Sabres,0,0,0,0
"108,1",2022-01-17,Minnesota Wild,0,Colorado Avalanche,0,0,0,0
"108,2",2022-01-17,Montréal Canadiens,0,Arizona Coyotes,0,0,0,0
"108,3",2022-01-17,Los Angeles Kings,0,San Jose Sharks,0,0,0,0
"108,4",2022-01-17,Chicago Blackhawks,0,Seattle Kraken,0,0,0,0
"108,5",2022-01-17,New Jersey Devils,0,Toronto Maple Leafs,0,0,0,0
"108,6",2022-01-17,Philadelphia Flyers,0,New York Islanders,0,0,0,0
"108,7",2022-01-17,Nashville Predators,0,St. Louis Blues,0,0,0,0
"108,8",2022-01-17,Pittsburgh Penguins,0,Vegas Golden Knights,0,0,0,0
"109,0",2022-01-18,Carolina Hurricanes,0,Boston Bruins,0,0,0,0
"109,1",2022-01-18,Buffalo Sabres,0,Ottawa Senators,0,0,1,0
"109,2",2022-01-18,Columbus Blue Jackets,0,New York Islanders,0,0,0,1
"109,3",2022-01-18,Detroit Red Wings,0,Philadelphia Flyers,0,0,1,1
"109,4",2022-01-18,Winnipeg Jets,0,Washington Capitals,0,0,0,0
"109,5",2022-01-18,Vancouver Canucks,0,Nashville Predators,0,0,0,1
"109,6",2022-01-18,Montréal Canadiens,0,Dallas Stars,0,0,1,0
"109,7",2022-01-18,Florida Panthers,0,Calgary Flames,0,0,0,0
"109,8",2022-01-18,Chicago Blackhawks,0,Edmonton Oilers,0,0,1,0
"109,9",2022-01-18,Tampa Bay Lightning,0,Los Angeles Kings,0,0,0,1
"110,0",2022-01-19,Arizona Coyotes,0,New Jersey Devils,0,0,0,0
"110,1",2022-01-19,Toronto Maple Leafs,0,New York Rangers,0,0,0,0
"110,2",2022-01-19,Colorado Avalanche,0,Anaheim Ducks,0,0,0,0
"111,0",2022-01-20,Washington Capitals,0,Boston Bruins,0,0,0,0
"111,1",2022-01-20,Dallas Stars,0,Buffalo Sabres,0,0,0,0
"111,2",2022-01-20,Columbus Blue Jackets,0,Philadelphia Flyers,0,0,0,0
"111,3",2022-01-20,Ottawa Senators,0,Pittsburgh Penguins,0,0,0,0
"111,4",2022-01-20,Winnipeg Jets,0,Nashville Predators,0,0,0,0
"111,5",2022-01-20,Florida Panthers,0,Edmonton Oilers,0,0,0,0
"111,6",2022-01-20,Colorado Avalanche,0,Los Angeles Kings,0,0,1,0
"111,7",2022-01-20,Montréal Canadiens,0,Vegas Golden Knights,0,0,0,0
"111,8",2022-01-20,San Jose Sharks,0,Seattle Kraken,0,0,0,0
"112,0",2022-01-21,New York Rangers,0,Carolina Hurricanes,0,0,0,0
"112,1",2022-01-21,Pittsburgh Penguins,0,Columbus Blue Jackets,0,0,1,1
"112,2",2022-01-21,Dallas Stars,0,Detroit Red Wings,0,0,1,0
"112,3",2022-01-21,Arizona Coyotes,0,New York Islanders,0,0,0,0
"112,4",2022-01-21,Minnesota Wild,0,Chicago Blackhawks,0,0,0,0
"112,5",2022-01-21,Florida Panthers,0,Vancouver Canucks,0,0,1,0
"112,6",2022-01-21,Tampa Bay Lightning,0,Anaheim Ducks,0,0,0,0
"112,7",2022-01-21,St. Louis Blues,0,Seattle Kraken,0,0,0,1
"113,0",2022-01-22,Philadelphia Flyers,0,Buffalo Sabres,0,0,0,0
"113,1",2022-01-22,Winnipeg Jets,0,Boston Bruins,0,0,0,0
"113,2",2022-01-22,New York Islanders,0,Toronto Maple Leafs,0,0,1,0
"113,3",2022-01-22,Carolina Hurricanes,0,New Jersey Devils,0,0,1,0
"113,4",2022-01-22,Arizona Coyotes,0,New York Rangers,0,0,1,1
"113,5",2022-01-22,Ottawa Senators,0,Washington Capitals,0,0,0,0
"113,6",2022-01-22,Montréal Canadiens,0,Colorado Avalanche,0,0,0,0
"113,7",2022-01-22,Detroit Red Wings,0,Nashville Predators,0,0,1,0
"113,8",2022-01-22,Chicago Blackhawks,0,Minnesota Wild,0,0,1,1
"113,9",2022-01-22,Calgary Flames,0,Edmonton Oilers,0,0,0,0
"113,10",2022-01-22,Tampa Bay Lightning,0,San Jose Sharks,0,0,1,0
"114,0",2022-01-23,Winnipeg Jets,0,Pittsburgh Penguins,0,0,1,0
"114,1",2022-01-23,Ottawa Senators,0,Columbus Blue Jackets,0,0,1,0
"114,2",2022-01-23,Los Angeles Kings,0,New Jersey Devils,0,0,0,1
"114,3",2022-01-23,Florida Panthers,0,Seattle Kraken,0,0,0,0
"114,4",2022-01-23,St. Louis Blues,0,Vancouver Canucks,0,0,0,0
"115,0",2022-01-24,Anaheim Ducks,0,Boston Bruins,0,0,0,0
"115,1",2022-01-24,Los Angeles Kings,0,New York Rangers,0,0,1,0
"115,2",2022-01-24,Dallas Stars,0,Philadelphia Flyers,0,0,0,0
"115,3",2022-01-24,Vegas Golden Knights,0,Washington Capitals,0,0,0,0
"115,4",2022-01-24,Montréal Canadiens,0,Minnesota Wild,0,0,0,0
"115,5",2022-01-24,Chicago Blackhawks,0,Colorado Avalanche,0,0,0,0
"115,6",2022-01-24,St. Louis Blues,0,Calgary Flames,0,0,1,0
"116,0",2022-01-25,Buffalo Sabres,0,Ottawa Senators,0,0,0,0
"116,1",2022-01-25,Dallas Stars,0,New Jersey Devils,0,0,1,0
"116,2",2022-01-25,Arizona Coyotes,0,Pittsburgh Penguins,0,0,0,0
"116,3",2022-01-25,Vegas Golden Knights,0,Carolina Hurricanes,0,0,1,0
"116,4",2022-01-25,Philadelphia Flyers,0,New York Islanders,0,0,1,0
"116,5",2022-01-25,Florida Panthers,0,Winnipeg Jets,0,0,0,0
"116,6",2022-01-25,Edmonton Oilers,0,Vancouver Canucks,0,0,0,0
"116,7",2022-01-25,Nashville Predators,0,Seattle Kraken,0,0,0,0
"117,0",2022-01-26,Anaheim Ducks,0,Toronto Maple Leafs,0,0,0,0
"117,1",2022-01-26,San Jose Sharks,0,Washington Capitals,0,0,0,0
"117,2",2022-01-26,Calgary Flames,0,Columbus Blue Jackets,0,0,0,0
"117,3",2022-01-26,Chicago Blackhawks,0,Detroit Red Wings,0,0,0,0
"117,4",2022-01-26,Boston Bruins,0,Colorado Avalanche,0,0,0,0
"118,0",2022-01-27,Anaheim Ducks,0,Montréal Canadiens,0,0,1,0
"118,1",2022-01-27,Carolina Hurricanes,0,Ottawa Senators,0,0,0,0
"118,2",2022-01-27,New Jersey Devils,0,Tampa Bay Lightning,0,0,0,0
"118,3",2022-01-27,Vegas Golden Knights,0,Florida Panthers,0,0,0,0
"118,4",2022-01-27,Los Angeles Kings,0,New York Islanders,0,0,0,0
"118,5",2022-01-27,Seattle Kraken,0,Pittsburgh Penguins,0,0,0,0
"118,6",2022-01-27,New York Rangers,0,Columbus Blue Jackets,0,0,0,1
"118,7",2022-01-27,Calgary Flames,0,St. Louis Blues,0,0,1,0
"118,8",2022-01-27,Vancouver Canucks,0,Winnipeg Jets,0,0,0,0
"118,9",2022-01-27,Nashville Predators,0,Edmonton Oilers,0,0,0,0
"119,0",2022-01-28,Detroit Red Wings,0,Pittsburgh Penguins,0,0,0,1
"119,1",2022-01-28,Minnesota Wild,0,New York Rangers,0,0,0,1
"119,2",2022-01-28,Colorado Avalanche,0,Chicago Blackhawks,0,0,0,0
"119,3",2022-01-28,Washington Capitals,0,Dallas Stars,0,0,0,0
"119,4",2022-01-28,Boston Bruins,0,Arizona Coyotes,0,0,0,0
"120,0",2022-01-29,Anaheim Ducks,0,Ottawa Senators,0,0,0,0
"120,1",2022-01-29,Los Angeles Kings,0,Philadelphia Flyers,0,0,0,0
"120,2",2022-01-29,Seattle Kraken,0,New York Islanders,0,0,0,0
"120,3",2022-01-29,Winnipeg Jets,0,St. Louis Blues,0,0,0,0
"120,4",2022-01-29,San Jose Sharks,0,Florida Panthers,0,0,0,0
"120,5",2022-01-29,Edmonton Oilers,0,Montréal Canadiens,0,0,0,0
"120,6",2022-01-29,Toronto Maple Leafs,0,Detroit Red Wings,0,0,0,1
"120,7",2022-01-29,Vegas Golden Knights,0,Tampa Bay Lightning,0,0,0,0
"120,8",2022-01-29,New Jersey Devils,0,Carolina Hurricanes,0,0,0,0
"120,9",2022-01-29,Buffalo Sabres,0,Arizona Coyotes,0,0,0,1
"120,10",2022-01-29,Vancouver Canucks,0,Calgary Flames,0,0,0,0
"121,0",2022-01-30,Seattle Kraken,0,New York Rangers,0,0,1,0
"121,1",2022-01-30,Los Angeles Kings,0,Pittsburgh Penguins,0,0,1,0
"121,2",2022-01-30,San Jose Sharks,0,Carolina Hurricanes,0,0,1,1
"121,3",2022-01-30,Columbus Blue Jackets,0,Montréal Canadiens,0,0,0,1
"121,4",2022-01-30,Chicago Blackhawks,0,St. Louis Blues,0,0,0,1
"121,5",2022-01-30,Boston Bruins,0,Dallas Stars,0,0,0,0
"121,6",2022-01-30,Minnesota Wild,0,New York Islanders,0,0,0,1
"121,7",2022-01-30,Buffalo Sabres,0,Colorado Avalanche,0,0,1,0
"122,0",2022-01-31,Florida Panthers,0,Columbus Blue Jackets,0,0,0,1
"122,1",2022-01-31,Edmonton Oilers,0,Ottawa Senators,0,0,0,0
"122,2",2022-01-31,Anaheim Ducks,0,Detroit Red Wings,0,0,0,0
"122,3",2022-01-31,Vancouver Canucks,0,Chicago Blackhawks,0,0,0,1
"123,0",2022-02-01,Seattle Kraken,0,Boston Bruins,0,0,0,0
"123,1",2022-02-01,St. Louis Blues,0,Montréal Canadiens,0,0,0,0
"123,2",2022-02-01,San Jose Sharks,0,Tampa Bay Lightning,0,0,0,0
"123,3",2022-02-01,Toronto Maple Leafs,0,New Jersey Devils,0,0,0,0
"123,4",2022-02-01,Florida Panthers,0,New York Rangers,0,0,1,0
"123,5",2022-02-01,Winnipeg Jets,0,Philadelphia Flyers,0,0,0,0
"123,6",2022-02-01,Washington Capitals,0,Pittsburgh Penguins,0,0,0,0
"123,7",2022-02-01,Ottawa Senators,0,New York Islanders,0,0,1,0
"123,8",2022-02-01,Vancouver Canucks,0,Nashville Predators,0,0,1,0
"123,9",2022-02-01,Calgary Flames,0,Dallas Stars,0,0,0,0
"123,10",2022-02-01,Arizona Coyotes,0,Colorado Avalanche,0,0,0,0
"123,11",2022-02-01,Buffalo Sabres,0,Vegas Golden Knights,0,0,0,0
"124,0",2022-02-02,Edmonton Oilers,0,Washington Capitals,0,0,0,1
"124,1",2022-02-02,Los Angeles Kings,0,Detroit Red Wings,0,0,0,0
"124,2",2022-02-02,Minnesota Wild,0,Chicago Blackhawks,0,0,0,0
"124,3",2022-02-02,Calgary Flames,0,Arizona Coyotes,0,0,1,1
"125,0",2022-02-23,Philadelphia Flyers,0,Detroit Red Wings,0,0,0,0
"125,1",2022-02-23,Edmonton Oilers,0,Tampa Bay Lightning,0,0,0,0
"125,2",2022-02-23,Winnipeg Jets,0,Dallas Stars,0,0,0,0
"125,3",2022-02-23,Los Angeles Kings,0,Arizona Coyotes,0,0,0,0
"126,0",2022-02-24,Minnesota Wild,0,Toronto Maple Leafs,0,0,0,0
"126,1",2022-02-24,Columbus Blue Jackets,0,Florida Panthers,0,0,0,0
"126,2",2022-02-24,Pittsburgh Penguins,0,New Jersey Devils,0,0,0,0
"126,3",2022-02-24,Washington Capitals,0,New York Rangers,0,0,0,0
"126,4",2022-02-24,Dallas Stars,0,Nashville Predators,0,0,1,0
"126,5",2022-02-24,Calgary Flames,0,Vancouver Canucks,0,0,0,0
"126,6",2022-02-24,Boston Bruins,0,Seattle Kraken,0,0,0,0
"126,7",2022-02-24,New York Islanders,0,San Jose Sharks,0,0,0,0
"127,0",2022-02-25,Columbus Blue Jackets,0,Carolina Hurricanes,0,0,1,0
"127,1",2022-02-25,Buffalo Sabres,0,St. Louis Blues,0,0,0,0
"127,2",2022-02-25,New Jersey Devils,0,Chicago Blackhawks,0,0,1,0
"127,3",2022-02-25,Winnipeg Jets,0,Colorado Avalanche,0,0,0,0
"127,4",2022-02-25,Vegas Golden Knights,0,Arizona Coyotes,0,0,0,0
"127,5",2022-02-25,Los Angeles Kings,0,Anaheim Ducks,0,0,0,0
"128,0",2022-02-26,Edmonton Oilers,0,Florida Panthers,0,0,0,0
"128,1",2022-02-26,Washington Capitals,0,Philadelphia Flyers,0,0,0,0
"128,2",2022-02-26,New York Rangers,0,Pittsburgh Penguins,0,0,0,0
"128,3",2022-02-26,Detroit Red Wings,0,Toronto Maple Leafs,0,0,0,0
"128,4",2022-02-26,Montréal Canadiens,0,Ottawa Senators,0,0,0,0
"128,5",2022-02-26,Tampa Bay Lightning,0,Nashville Predators,0,0,0,0
"128,6",2022-02-26,Minnesota Wild,0,Calgary Flames,0,0,0,0
"128,7",2022-02-26,Colorado Avalanche,0,Vegas Golden Knights,0,0,1,1
"128,8",2022-02-26,Boston Bruins,0,San Jose Sharks,0,0,0,0
"128,9",2022-02-26,New York Islanders,0,Los Angeles Kings,0,0,0,1
"129,0",2022-02-27,Edmonton Oilers,0,Carolina Hurricanes,0,0,1,0
"129,1",2022-02-27,Buffalo Sabres,0,Dallas Stars,0,0,0,0
"129,2",2022-02-27,St. Louis Blues,0,Chicago Blackhawks,0,0,0,0
"129,3",2022-02-27,Winnipeg Jets,0,Arizona Coyotes,0,0,0,0
"129,4",2022-02-27,Pittsburgh Penguins,0,Columbus Blue Jackets,0,0,1,0
"129,5",2022-02-27,Vancouver Canucks,0,New York Rangers,0,0,0,1
"129,6",2022-02-27,New York Islanders,0,Anaheim Ducks,0,0,1,0
"129,7",2022-02-27,Seattle Kraken,0,San Jose Sharks,0,0,0,1
"130,0",2022-02-28,St. Louis Blues,0,Philadelphia Flyers,0,0,1,0
"130,1",2022-02-28,Vancouver Canucks,0,New Jersey Devils,0,0,1,0
"130,2",2022-02-28,Toronto Maple Leafs,0,Washington Capitals,0,0,0,0
"130,3",2022-02-28,Boston Bruins,0,Los Angeles Kings,0,0,0,0
"131,0",2022-03-01,Ottawa Senators,0,Tampa Bay Lightning,0,0,0,0
"131,1",2022-03-01,Edmonton Oilers,0,Philadelphia Flyers,0,0,0,1
"131,2",2022-03-01,New Jersey Devils,0,Columbus Blue Jackets,0,0,1,0
"131,3",2022-03-01,Carolina Hurricanes,0,Detroit Red Wings,0,0,0,0
"131,4",2022-03-01,Calgary Flames,0,Minnesota Wild,0,0,0,0
"131,5",2022-03-01,Montréal Canadiens,0,Winnipeg Jets,0,0,0,0
"131,6",2022-03-01,New York Islanders,0,Colorado Avalanche,0,0,0,0
"131,7",2022-03-01,San Jose Sharks,0,Vegas Golden Knights,0,0,0,0
"131,8",2022-03-01,Boston Bruins,0,Anaheim Ducks,0,0,1,0
"132,0",2022-03-02,Buffalo Sabres,0,Toronto Maple Leafs,0,0,0,0
"132,1",2022-03-02,St. Louis Blues,0,New York Rangers,0,0,0,0
"132,2",2022-03-02,Los Angeles Kings,0,Dallas Stars,0,0,0,0
"132,3",2022-03-02,Nashville Predators,0,Seattle Kraken,0,0,0,0
"133,0",2022-03-03,Pittsburgh Penguins,0,Tampa Bay Lightning,0,0,0,0
"133,1",2022-03-03,Ottawa Senators,0,Florida Panthers,0,0,0,0
"133,2",2022-03-03,Minnesota Wild,0,Philadelphia Flyers,0,0,0,0
"133,3",2022-03-03,Carolina Hurricanes,0,Washington Capitals,0,0,0,0
"133,4",2022-03-03,Vancouver Canucks,0,New York Islanders,0,0,0,0
"133,5",2022-03-03,Edmonton Oilers,0,Chicago Blackhawks,0,0,0,0
"133,6",2022-03-03,Montréal Canadiens,0,Calgary Flames,0,0,0,0
"133,7",2022-03-03,Colorado Avalanche,0,Arizona Coyotes,0,0,0,0
"133,8",2022-03-03,Boston Bruins,0,Vegas Golden Knights,0,0,0,0
"134,0",2022-03-04,Minnesota Wild,0,Buffalo Sabres,0,0,1,0
"134,1",2022-03-04,Detroit Red Wings,0,Tampa Bay Lightning,0,0,0,1
"134,2",2022-03-04,New Jersey Devils,0,New York Rangers,0,0,0,0
"134,3",2022-03-04,Pittsburgh Penguins,0,Carolina Hurricanes,0,0,1,1
"134,4",2022-03-04,Los Angeles Kings,0,Columbus Blue Jackets,0,0,0,0
"134,5",2022-03-04,Dallas Stars,0,Winnipeg Jets,0,0,0,0
"134,6",2022-03-04,Vegas Golden Knights,0,Anaheim Ducks,0,0,1,0
"135,0",2022-03-05,St. Louis Blues,0,New York Islanders,0,0,0,0
"135,1",2022-03-05,Chicago Blackhawks,0,Philadelphia Flyers,0,0,0,0
"135,2",2022-03-05,Ottawa Senators,0,Arizona Coyotes,0,0,0,0
"135,3",2022-03-05,Detroit Red Wings,0,Florida Panthers,0,0,1,0
"135,4",2022-03-05,Vancouver Canucks,0,Toronto Maple Leafs,0,0,0,0
"135,5",2022-03-05,Seattle Kraken,0,Washington Capitals,0,0,0,0
"135,6",2022-03-05,Boston Bruins,0,Columbus Blue Jackets,0,0,0,1
"135,7",2022-03-05,Montréal Canadiens,0,Edmonton Oilers,0,0,0,0
"135,8",2022-03-05,Nashville Predators,0,San Jose Sharks,0,0,0,0
"135,9",2022-03-05,Calgary Flames,0,Colorado Avalanche,0,0,0,0
"136,0",2022-03-06,Los Angeles Kings,0,Buffalo Sabres,0,0,0,0
"136,1",2022-03-06,St. Louis Blues,0,New Jersey Devils,0,0,1,0
"136,2",2022-03-06,Dallas Stars,0,Minnesota Wild,0,0,0,0
"136,3",2022-03-06,Seattle Kraken,0,Carolina Hurricanes,0,0,1,0
"136,4",2022-03-06,Tampa Bay Lightning,0,Chicago Blackhawks,0,0,0,1
"136,5",2022-03-06,New York Rangers,0,Winnipeg Jets,0,0,0,0
"136,6",2022-03-06,Ottawa Senators,0,Vegas Golden Knights,0,0,1,0
"136,7",2022-03-06,San Jose Sharks,0,Anaheim Ducks,0,0,1,0
"137,0",2022-03-07,Los Angeles Kings,0,Boston Bruins,0,0,1,0
"137,1",2022-03-07,Florida Panthers,0,Buffalo Sabres,0,0,0,1
"137,2",2022-03-07,Colorado Avalanche,0,New York Islanders,0,0,0,0
"137,3",2022-03-07,Toronto Maple Leafs,0,Columbus Blue Jackets,0,0,0,0
"138,0",2022-03-08,Colorado Avalanche,0,New Jersey Devils,0,0,1,0
"138,1",2022-03-08,Vegas Golden Knights,0,Philadelphia Flyers,0,0,0,0
"138,2",2022-03-08,Florida Panthers,0,Pittsburgh Penguins,0,0,1,0
"138,3",2022-03-08,Arizona Coyotes,0,Detroit Red Wings,0,0,0,0
"138,4",2022-03-08,Seattle Kraken,0,Toronto Maple Leafs,0,0,0,1
"138,5",2022-03-08,Ottawa Senators,0,St. Louis Blues,0,0,0,0
"138,6",2022-03-08,Dallas Stars,0,Nashville Predators,0,0,0,0
"138,7",2022-03-08,New York Rangers,0,Minnesota Wild,0,0,0,0
"138,8",2022-03-08,Tampa Bay Lightning,0,Winnipeg Jets,0,0,0,0
"138,9",2022-03-08,Anaheim Ducks,0,Chicago Blackhawks,0,0,0,0
"138,10",2022-03-08,Washington Capitals,0,Calgary Flames,0,0,0,0
"139,0",2022-03-09,Washington Capitals,0,Edmonton Oilers,0,0,1,0
"139,1",2022-03-09,Montréal Canadiens,0,Vancouver Canucks,0,0,0,0
"140,0",2022-03-10,Chicago Blackhawks,0,Boston Bruins,0,0,0,0
"140,1",2022-03-10,Vegas Golden Knights,0,Buffalo Sabres,0,0,0,0
"140,2",2022-03-10,Arizona Coyotes,0,Toronto Maple Leafs,0,0,0,0
"140,3",2022-03-10,Seattle Kraken,0,Ottawa Senators,0,0,0,0
"140,4",2022-03-10,Minnesota Wild,0,Detroit Red Wings,0,0,0,0
"140,5",2022-03-10,Philadelphia Flyers,0,Florida Panthers,0,0,0,0
"140,6",2022-03-10,Winnipeg Jets,0,New Jersey Devils,0,0,0,0
"140,7",2022-03-10,Colorado Avalanche,0,Carolina Hurricanes,0,0,0,0
"140,8",2022-03-10,Pittsburgh Penguins,0,New York Islanders,0,0,0,0
"140,9",2022-03-10,New York Rangers,0,St. Louis Blues,0,0,0,0
"140,10",2022-03-10,Anaheim Ducks,0,Nashville Predators,0,0,0,0
"140,11",2022-03-10,Tampa Bay Lightning,0,Calgary Flames,0,0,0,0
"140,12",2022-03-10,San Jose Sharks,0,Los Angeles Kings,0,0,0,0
"141,0",2022-03-11,Vegas Golden Knights,0,Pittsburgh Penguins,0,0,1,1
"141,1",2022-03-11,Minnesota Wild,0,Columbus Blue Jackets,0,0,1,0
"141,2",2022-03-11,Winnipeg Jets,0,New York Islanders,0,0,1,1
"141,3",2022-03-11,Washington Capitals,0,Vancouver Canucks,0,0,0,0
"142,0",2022-03-12,St. Louis Blues,0,Nashville Predators,0,0,0,0
"142,1",2022-03-12,Philadelphia Flyers,0,Carolina Hurricanes,0,0,0,0
"142,2",2022-03-12,Arizona Coyotes,0,Boston Bruins,0,0,0,0
"142,3",2022-03-12,Seattle Kraken,0,Montréal Canadiens,0,0,0,0
"142,4",2022-03-12,Chicago Blackhawks,0,Ottawa Senators,0,0,0,0
"142,5",2022-03-12,Anaheim Ducks,0,New Jersey Devils,0,0,0,0
"142,6",2022-03-12,Detroit Red Wings,0,Calgary Flames,0,0,0,0
"142,7",2022-03-12,New York Rangers,0,Dallas Stars,0,0,0,0
"142,8",2022-03-12,Los Angeles Kings,0,San Jose Sharks,0,0,0,0
"142,9",2022-03-12,Tampa Bay Lightning,0,Edmonton Oilers,0,0,0,0
"143,0",2022-03-13,Toronto Maple Leafs,0,Buffalo Sabres,0,0,0,0
"143,1",2022-03-13,Carolina Hurricanes,0,Pittsburgh Penguins,0,0,1,0
"143,2",2022-03-13,Vegas Golden Knights,0,Columbus Blue Jackets,0,0,0,0
"143,3",2022-03-13,Nashville Predators,0,Minnesota Wild,0,0,1,0
"143,4",2022-03-13,Montréal Canadiens,0,Philadelphia Flyers,0,0,1,1
"143,5",2022-03-13,Winnipeg Jets,0,St. Louis Blues,0,0,0,1
"143,6",2022-03-13,Anaheim Ducks,0,New York Islanders,0,0,1,0
"143,7",2022-03-13,Calgary Flames,0,Colorado Avalanche,0,0,1,0
"143,8",2022-03-13,Tampa Bay Lightning,0,Vancouver Canucks,0,0,1,0
"143,9",2022-03-13,Florida Panthers,0,Los Angeles Kings,0,0,0,1
"144,0",2022-03-14,Arizona Coyotes,0,Ottawa Senators,0,0,0,0
"145,0",2022-03-15,Dallas Stars,0,Toronto Maple Leafs,0,0,0,0
"145,1",2022-03-15,Arizona Coyotes,0,Montréal Canadiens,0,0,1,0
"145,2",2022-03-15,Anaheim Ducks,0,New York Rangers,0,0,0,0
"145,3",2022-03-15,New York Islanders,0,Washington Capitals,0,0,0,0
"145,4",2022-03-15,Pittsburgh Penguins,0,Nashville Predators,0,0,0,0
"145,5",2022-03-15,Vegas Golden Knights,0,Winnipeg Jets,0,0,0,0
"145,6",2022-03-15,Boston Bruins,0,Chicago Blackhawks,0,0,0,0
"145,7",2022-03-15,Detroit Red Wings,0,Edmonton Oilers,0,0,0,0
"145,8",2022-03-15,New Jersey Devils,0,Vancouver Canucks,0,0,0,0
"145,9",2022-03-15,Colorado Avalanche,0,Los Angeles Kings,0,0,0,0
"145,10",2022-03-15,Florida Panthers,0,San Jose Sharks,0,0,0,0
"146,0",2022-03-16,Columbus Blue Jackets,0,Ottawa Senators,0,0,0,0
"146,1",2022-03-16,Boston Bruins,0,Minnesota Wild,0,0,1,0
"146,2",2022-03-16,New Jersey Devils,0,Calgary Flames,0,0,1,0
"146,3",2022-03-16,Tampa Bay Lightning,0,Seattle Kraken,0,0,0,0
"147,0",2022-03-17,Carolina Hurricanes,0,Toronto Maple Leafs,0,0,0,0
"147,1",2022-03-17,Dallas Stars,0,Montréal Canadiens,0,0,0,0
"147,2",2022-03-17,Nashville Predators,0,Philadelphia Flyers,0,0,0,0
"147,3",2022-03-17,Washington Capitals,0,Columbus Blue Jackets,0,0,0,1
"147,4",2022-03-17,Pittsburgh Penguins,0,St. Louis Blues,0,0,0,0
"147,5",2022-03-17,Buffalo Sabres,0,Edmonton Oilers,0,0,0,0
"147,6",2022-03-17,Detroit Red Wings,0,Vancouver Canucks,0,0,0,0
"147,7",2022-03-17,San Jose Sharks,0,Los Angeles Kings,0,0,0,0
"147,8",2022-03-17,Florida Panthers,0,Vegas Golden Knights,0,0,0,0
"148,0",2022-03-18,Philadelphia Flyers,0,Ottawa Senators,0,0,1,0
"148,1",2022-03-18,Washington Capitals,0,Carolina Hurricanes,0,0,1,1
"148,2",2022-03-18,Boston Bruins,0,Winnipeg Jets,0,0,0,0
"148,3",2022-03-18,Buffalo Sabres,0,Calgary Flames,0,0,1,0
"148,4",2022-03-18,Florida Panthers,0,Anaheim Ducks,0,0,1,0
"148,5",2022-03-18,Colorado Avalanche,0,San Jose Sharks,0,0,0,1
"149,0",2022-03-19,Dallas Stars,0,New York Islanders,0,0,0,0
"149,1",2022-03-19,Chicago Blackhawks,0,Minnesota Wild,0,0,0,0
"149,2",2022-03-19,New Jersey Devils,0,Edmonton Oilers,0,0,0,0
"149,3",2022-03-19,Los Angeles Kings,0,Vegas Golden Knights,0,0,0,0
"149,4",2022-03-19,St. Louis Blues,0,Columbus Blue Jackets,0,0,0,0
"149,5",2022-03-19,Pittsburgh Penguins,0,Arizona Coyotes,0,0,0,0
"149,6",2022-03-19,Ottawa Senators,0,Montréal Canadiens,0,0,1,0
"149,7",2022-03-19,Toronto Maple Leafs,0,Nashville Predators,0,0,0,0
"149,8",2022-03-19,New York Rangers,0,Tampa Bay Lightning,0,0,0,0
"149,9",2022-03-19,Calgary Flames,0,Vancouver Canucks,0,0,1,0
"149,10",2022-03-19,Detroit Red Wings,0,Seattle Kraken,0,0,0,0
"150,0",2022-03-20,New York Islanders,0,Philadelphia Flyers,0,0,1,0
"150,1",2022-03-20,Dallas Stars,0,Washington Capitals,0,0,1,0
"150,2",2022-03-20,New York Rangers,0,Carolina Hurricanes,0,0,1,0
"150,3",2022-03-20,Winnipeg Jets,0,Chicago Blackhawks,0,0,0,1
"150,4",2022-03-20,Arizona Coyotes,0,San Jose Sharks,0,0,1,0
"150,5",2022-03-20,Buffalo Sabres,0,Vancouver Canucks,0,0,0,1
"151,0",2022-03-21,Montréal Canadiens,0,Boston Bruins,0,0,0,0
"151,1",2022-03-21,Vegas Golden Knights,0,Minnesota Wild,0,0,0,0
"151,2",2022-03-21,Edmonton Oilers,0,Colorado Avalanche,0,0,0,0
"151,3",2022-03-21,Nashville Predators,0,Anaheim Ducks,0,0,0,0
"152,0",2022-03-22,New York Rangers,0,New Jersey Devils,0,0,0,0
"152,1",2022-03-22,Columbus Blue Jackets,0,Pittsburgh Penguins,0,0,0,0
"152,2",2022-03-22,St. Louis Blues,0,Washington Capitals,0,0,0,0
"152,3",2022-03-22,Tampa Bay Lightning,0,Carolina Hurricanes,0,0,0,0
"152,4",2022-03-22,Philadelphia Flyers,0,Detroit Red Wings,0,0,0,0
"152,5",2022-03-22,Boston Bruins,0,New York Islanders,0,0,1,0
"152,6",2022-03-22,Vegas Golden Knights,0,Winnipeg Jets,0,0,1,0
"152,7",2022-03-22,Edmonton Oilers,0,Dallas Stars,0,0,1,0
"152,8",2022-03-22,San Jose Sharks,0,Calgary Flames,0,0,0,0
"152,9",2022-03-22,Nashville Predators,0,Los Angeles Kings,0,0,1,0
"153,0",2022-03-23,New Jersey Devils,0,Toronto Maple Leafs,0,0,1,0
"153,1",2022-03-23,Pittsburgh Penguins,0,Buffalo Sabres,0,0,1,0
"153,2",2022-03-23,Vancouver Canucks,0,Colorado Avalanche,0,0,0,0
"153,3",2022-03-23,Seattle Kraken,0,Arizona Coyotes,0,0,0,0
"153,4",2022-03-23,Chicago Blackhawks,0,Anaheim Ducks,0,0,0,0
"154,0",2022-03-24,Tampa Bay Lightning,0,Boston Bruins,0,0,0,0
"154,1",2022-03-24,Florida Panthers,0,Montréal Canadiens,0,0,0,0
"154,2",2022-03-24,Dallas Stars,0,Carolina Hurricanes,0,0,0,0
"154,3",2022-03-24,Ottawa Senators,0,New York Islanders,0,0,0,0
"154,4",2022-03-24,Philadelphia Flyers,0,St. Louis Blues,0,0,0,0
"154,5",2022-03-24,Vancouver Canucks,0,Minnesota Wild,0,0,1,0
"154,6",2022-03-24,San Jose Sharks,0,Edmonton Oilers,0,0,0,0
"154,7",2022-03-24,Nashville Predators,0,Vegas Golden Knights,0,0,0,0
"154,8",2022-03-24,Chicago Blackhawks,0,Los Angeles Kings,0,0,1,0
"155,0",2022-03-25,Washington Capitals,0,Buffalo Sabres,0,0,0,0
"155,1",2022-03-25,Pittsburgh Penguins,0,New York Rangers,0,0,0,0
"155,2",2022-03-25,Columbus Blue Jackets,0,Winnipeg Jets,0,0,0,0
"155,3",2022-03-25,Philadelphia Flyers,0,Colorado Avalanche,0,0,1,0
"155,4",2022-03-25,Arizona Coyotes,0,Calgary Flames,0,0,0,0
"155,5",2022-03-25,Seattle Kraken,0,Anaheim Ducks,0,0,0,0
"156,0",2022-03-26,New York Islanders,0,Boston Bruins,0,0,0,0
"156,1",2022-03-26,Tampa Bay Lightning,0,Detroit Red Wings,0,0,0,0
"156,2",2022-03-26,Chicago Blackhawks,0,Vegas Golden Knights,0,0,0,0
"156,3",2022-03-26,Toronto Maple Leafs,0,Montréal Canadiens,0,0,0,0
"156,4",2022-03-26,Florida Panthers,0,Ottawa Senators,0,0,0,0
"156,5",2022-03-26,New Jersey Devils,0,Washington Capitals,0,0,0,1
"156,6",2022-03-26,Vancouver Canucks,0,Dallas Stars,0,0,0,0
"156,7",2022-03-26,Carolina Hurricanes,0,St. Louis Blues,0,0,0,0
"156,8",2022-03-26,Columbus Blue Jackets,0,Minnesota Wild,0,0,1,0
"156,9",2022-03-26,Edmonton Oilers,0,Calgary Flames,0,0,0,1
"156,10",2022-03-26,Seattle Kraken,0,Los Angeles Kings,0,0,1,0
"156,11",2022-03-26,Anaheim Ducks,0,San Jose Sharks,0,0,1,0
"157,0",2022-03-27,Tampa Bay Lightning,0,New York Islanders,0,0,1,1
"157,1",2022-03-27,Buffalo Sabres,0,New York Rangers,0,0,0,0
"157,2",2022-03-27,Detroit Red Wings,0,Pittsburgh Penguins,0,0,1,0
"157,3",2022-03-27,Philadelphia Flyers,0,Nashville Predators,0,0,0,0
"157,4",2022-03-27,Colorado Avalanche,0,Minnesota Wild,0,0,0,1
"157,5",2022-03-27,Florida Panthers,0,Toronto Maple Leafs,0,0,1,1
"157,6",2022-03-27,Montréal Canadiens,0,New Jersey Devils,0,0,1,1
"157,7",2022-03-27,Arizona Coyotes,0,Winnipeg Jets,0,0,0,0
"158,0",2022-03-28,Carolina Hurricanes,0,Washington Capitals,0,0,0,0
"158,1",2022-03-28,Vancouver Canucks,0,St. Louis Blues,0,0,0,0
"158,2",2022-03-28,Buffalo Sabres,0,Chicago Blackhawks,0,0,1,0
"158,3",2022-03-28,Arizona Coyotes,0,Edmonton Oilers,0,0,1,0
"158,4",2022-03-28,Seattle Kraken,0,Los Angeles Kings,0,0,0,0
"159,0",2022-03-29,Toronto Maple Leafs,0,Boston Bruins,0,0,0,0
"159,1",2022-03-29,Carolina Hurricanes,0,Tampa Bay Lightning,0,0,1,0
"159,2",2022-03-29,Montréal Canadiens,0,Florida Panthers,0,0,0,0
"159,3",2022-03-29,New York Rangers,0,Pittsburgh Penguins,0,0,0,0
"159,4",2022-03-29,New York Islanders,0,Columbus Blue Jackets,0,0,0,0
"159,5",2022-03-29,Ottawa Senators,0,Nashville Predators,0,0,0,0
"159,6",2022-03-29,Philadelphia Flyers,0,Minnesota Wild,0,0,0,0
"159,7",2022-03-29,Colorado Avalanche,0,Calgary Flames,0,0,0,0
"159,8",2022-03-29,Dallas Stars,0,Anaheim Ducks,0,0,0,0
"160,0",2022-03-30,Winnipeg Jets,0,Buffalo Sabres,0,0,0,0
"160,1",2022-03-30,New York Rangers,0,Detroit Red Wings,0,0,1,0
"160,2",2022-03-30,Los Angeles Kings,0,Edmonton Oilers,0,0,0,0
"160,3",2022-03-30,St. Louis Blues,0,Vancouver Canucks,0,0,0,0
"160,4",2022-03-30,San Jose Sharks,0,Arizona Coyotes,0,0,0,0
"160,5",2022-03-30,Vegas Golden Knights,0,Seattle Kraken,0,0,0,0
"161,0",2022-03-31,New Jersey Devils,0,Boston Bruins,0,0,0,0
"161,1",2022-03-31,Winnipeg Jets,0,Toronto Maple Leafs,0,0,1,0
"161,2",2022-03-31,Chicago Blackhawks,0,Florida Panthers,0,0,0,0
"161,3",2022-03-31,Columbus Blue Jackets,0,New York Islanders,0,0,0,0
"161,4",2022-03-31,Montréal Canadiens,0,Carolina Hurricanes,0,0,0,0
"161,5",2022-03-31,Pittsburgh Penguins,0,Minnesota Wild,0,0,0,0
"161,6",2022-03-31,San Jose Sharks,0,Colorado Avalanche,0,0,1,0
"161,7",2022-03-31,Los Angeles Kings,0,Calgary Flames,0,0,1,0
"161,8",2022-03-31,Dallas Stars,0,Anaheim Ducks,0,0,0,0
"162,0",2022-04-01,Nashville Predators,0,Buffalo Sabres,0,0,0,0
"162,1",2022-04-01,Chicago Blackhawks,0,Tampa Bay Lightning,0,0,1,0
"162,2",2022-04-01,New York Islanders,0,New York Rangers,0,0,1,0
"162,3",2022-04-01,Ottawa Senators,0,Detroit Red Wings,0,0,0,0
"162,4",2022-04-01,St. Louis Blues,0,Edmonton Oilers,0,0,0,0
"162,5",2022-04-01,Vegas Golden Knights,0,Seattle Kraken,0,0,0,0
"162,6",2022-04-01,Anaheim Ducks,0,Arizona Coyotes,0,0,1,0
"163,0",2022-04-02,Florida Panthers,0,New Jersey Devils,0,0,0,0
"163,1",2022-04-02,Pittsburgh Penguins,0,Colorado Avalanche,0,0,0,0
"163,2",2022-04-02,Columbus Blue Jackets,0,Boston Bruins,0,0,0,0
"163,3",2022-04-02,Montréal Canadiens,0,Tampa Bay Lightning,0,0,0,1
"163,4",2022-04-02,Toronto Maple Leafs,0,Philadelphia Flyers,0,0,0,0
"163,5",2022-04-02,Minnesota Wild,0,Carolina Hurricanes,0,0,0,0
"163,6",2022-04-02,Los Angeles Kings,0,Winnipeg Jets,0,0,0,0
"163,7",2022-04-02,Washington Capitals,0,Nashville Predators,0,0,0,1
"163,8",2022-04-02,St. Louis Blues,0,Calgary Flames,0,0,1,0
"163,9",2022-04-02,Dallas Stars,0,San Jose Sharks,0,0,0,0
"164,0",2022-04-03,Florida Panthers,0,Buffalo Sabres,0,0,1,0
"164,1",2022-04-03,Detroit Red Wings,0,Ottawa Senators,0,0,0,0
"164,2",2022-04-03,New York Islanders,0,New Jersey Devils,0,0,0,1
"164,3",2022-04-03,Philadelphia Flyers,0,New York Rangers,0,0,1,0
"164,4",2022-04-03,Minnesota Wild,0,Washington Capitals,0,0,1,1
"164,5",2022-04-03,Arizona Coyotes,0,Chicago Blackhawks,0,0,0,0
"164,6",2022-04-03,Vegas Golden Knights,0,Vancouver Canucks,0,0,0,0
"164,7",2022-04-03,Edmonton Oilers,0,Anaheim Ducks,0,0,0,0
"164,8",2022-04-03,Dallas Stars,0,Seattle Kraken,0,0,1,0
"165,0",2022-04-04,Boston Bruins,0,Columbus Blue Jackets,0,0,0,0
"165,1",2022-04-04,Toronto Maple Leafs,0,Tampa Bay Lightning,0,0,0,0
"165,2",2022-04-04,Arizona Coyotes,0,St. Louis Blues,0,0,1,0
"165,3",2022-04-04,Calgary Flames,0,Los Angeles Kings,0,0,0,0
"166,0",2022-04-05,Carolina Hurricanes,0,Buffalo Sabres,0,0,0,0
"166,1",2022-04-05,Ottawa Senators,0,Montréal Canadiens,0,0,0,0
"166,2",2022-04-05,Toronto Maple Leafs,0,Florida Panthers,0,0,1,0
"166,3",2022-04-05,New York Rangers,0,New Jersey Devils,0,0,0,0
"166,4",2022-04-05,Columbus Blue Jackets,0,Philadelphia Flyers,0,0,1,0
"166,5",2022-04-05,Colorado Avalanche,0,Pittsburgh Penguins,0,0,0,0
"166,6",2022-04-05,Boston Bruins,0,Detroit Red Wings,0,0,1,0
"166,7",2022-04-05,Minnesota Wild,0,Nashville Predators,0,0,0,0
"166,8",2022-04-05,New York Islanders,0,Dallas Stars,0,0,0,0
"166,9",2022-04-05,Edmonton Oilers,0,San Jose Sharks,0,0,0,0
"167,0",2022-04-06,Tampa Bay Lightning,0,Washington Capitals,0,0,0,0
"167,1",2022-04-06,Detroit Red Wings,0,Winnipeg Jets,0,0,1,0
"167,2",2022-04-06,Seattle Kraken,0,St. Louis Blues,0,0,0,0
"167,3",2022-04-06,Vancouver Canucks,0,Vegas Golden Knights,0,0,0,0
"167,4",2022-04-06,Calgary Flames,0,Anaheim Ducks,0,0,0,0
"168,0",2022-04-07,New Jersey Devils,0,Ottawa Senators,0,0,0,0
"168,1",2022-04-07,Pittsburgh Penguins,0,New York Rangers,0,0,0,0
"168,2",2022-04-07,Philadelphia Flyers,0,Columbus Blue Jackets,0,0,0,0
"168,3",2022-04-07,Buffalo Sabres,0,Carolina Hurricanes,0,0,0,0
"168,4",2022-04-07,Seattle Kraken,0,Chicago Blackhawks,0,0,1,0
"168,5",2022-04-07,Toronto Maple Leafs,0,Dallas Stars,0,0,0,0
"168,6",2022-04-07,Vancouver Canucks,0,Arizona Coyotes,0,0,1,0
"168,7",2022-04-07,Edmonton Oilers,0,Los Angeles Kings,0,0,0,0
"168,8",2022-04-07,Calgary Flames,0,San Jose Sharks,0,0,1,0
"169,0",2022-04-08,Boston Bruins,0,Tampa Bay Lightning,0,0,0,0
"169,1",2022-04-08,Buffalo Sabres,0,Florida Panthers,0,0,1,0
"169,2",2022-04-08,New York Islanders,0,Carolina Hurricanes,0,0,0,1
"169,3",2022-04-08,Minnesota Wild,0,St. Louis Blues,0,0,0,0
"169,4",2022-04-08,Colorado Avalanche,0,Winnipeg Jets,0,0,0,0
"170,0",2022-04-09,New Jersey Devils,0,Dallas Stars,0,0,0,0
"170,1",2022-04-09,Washington Capitals,0,Pittsburgh Penguins,0,0,0,0
"170,2",2022-04-09,Florida Panthers,0,Nashville Predators,0,0,1,0
"170,3",2022-04-09,Montréal Canadiens,0,Toronto Maple Leafs,0,0,0,0
"170,4",2022-04-09,Columbus Blue Jackets,0,Detroit Red Wings,0,0,0,0
"170,5",2022-04-09,Ottawa Senators,0,New York Rangers,0,0,0,0
"170,6",2022-04-09,Calgary Flames,0,Seattle Kraken,0,0,0,0
"170,7",2022-04-09,Anaheim Ducks,0,Philadelphia Flyers,0,0,0,0
"170,8",2022-04-09,New York Islanders,0,St. Louis Blues,0,0,1,1
"170,9",2022-04-09,Colorado Avalanche,0,Edmonton Oilers,0,0,1,0
"170,10",2022-04-09,San Jose Sharks,0,Vancouver Canucks,0,0,0,0
"170,11",2022-04-09,Arizona Coyotes,0,Vegas Golden Knights,0,0,0,0
"171,0",2022-04-10,Boston Bruins,0,Washington Capitals,0,0,0,1
"171,1",2022-04-10,Nashville Predators,0,Pittsburgh Penguins,0,0,1,1
"171,2",2022-04-10,Los Angeles Kings,0,Minnesota Wild,0,0,0,0
"171,3",2022-04-10,Buffalo Sabres,0,Tampa Bay Lightning,0,0,0,0
"171,4",2022-04-10,Anaheim Ducks,0,Carolina Hurricanes,0,0,1,0
"171,5",2022-04-10,Dallas Stars,0,Chicago Blackhawks,0,0,1,0
"171,6",2022-04-10,Winnipeg Jets,0,Ottawa Senators,0,0,0,1
"171,7",2022-04-10,Vegas Golden Knights,0,San Jose Sharks,0,0,1,1
"172,0",2022-04-11,Winnipeg Jets,0,Montréal Canadiens,0,0,1,0
"173,0",2022-04-12,St. Louis Blues,0,Boston Bruins,0,0,0,0
"173,1",2022-04-12,Buffalo Sabres,0,Toronto Maple Leafs,0,0,0,0
"173,2",2022-04-12,Anaheim Ducks,0,Florida Panthers,0,0,0,0
"173,3",2022-04-12,Carolina Hurricanes,0,New York Rangers,0,0,0,0
"173,4",2022-04-12,Columbus Blue Jackets,0,Pittsburgh Penguins,0,0,0,0
"173,5",2022-04-12,Philadelphia Flyers,0,Washington Capitals,0,0,0,0
"173,6",2022-04-12,Ottawa Senators,0,Detroit Red Wings,0,0,0,0
"173,7",2022-04-12,Edmonton Oilers,0,Minnesota Wild,0,0,0,0
"173,8",2022-04-12,San Jose Sharks,0,Nashville Predators,0,0,0,0
"173,9",2022-04-12,Los Angeles Kings,0,Chicago Blackhawks,0,0,0,0
"173,10",2022-04-12,Seattle Kraken,0,Calgary Flames,0,0,0,0
"173,11",2022-04-12,Tampa Bay Lightning,0,Dallas Stars,0,0,0,0
"173,12",2022-04-12,Vegas Golden Knights,0,Vancouver Canucks,0,0,0,0
"173,13",2022-04-12,New Jersey Devils,0,Arizona Coyotes,0,0,0,0
"174,0",2022-04-13,New York Rangers,0,Philadelphia Flyers,0,0,1,1
"174,1",2022-04-13,Montréal Canadiens,0,Columbus Blue Jackets,0,0,0,1
"174,2",2022-04-13,Seattle Kraken,0,Winnipeg Jets,0,0,1,0
"174,3",2022-04-13,Los Angeles Kings,0,Colorado Avalanche,0,0,1,0
"175,0",2022-04-14,Ottawa Senators,0,Boston Bruins,0,0,0,0
"175,1",2022-04-14,St. Louis Blues,0,Buffalo Sabres,0,0,0,0
"175,2",2022-04-14,Washington Capitals,0,Toronto Maple Leafs,0,0,0,0
"175,3",2022-04-14,Anaheim Ducks,0,Tampa Bay Lightning,0,0,0,0
"175,4",2022-04-14,New York Islanders,0,Pittsburgh Penguins,0,0,0,0
"175,5",2022-04-14,Detroit Red Wings,0,Carolina Hurricanes,0,0,0,0
"175,6",2022-04-14,Edmonton Oilers,0,Nashville Predators,0,0,0,0
"175,7",2022-04-14,Minnesota Wild,0,Dallas Stars,0,0,0,0
"175,8",2022-04-14,San Jose Sharks,0,Chicago Blackhawks,0,0,0,0
"175,9",2022-04-14,New Jersey Devils,0,Colorado Avalanche,0,0,0,1
"175,10",2022-04-14,Vegas Golden Knights,0,Calgary Flames,0,0,0,0
"175,11",2022-04-14,Arizona Coyotes,0,Vancouver Canucks,0,0,0,0
"176,0",2022-04-15,New York Islanders,0,Montréal Canadiens,0,0,1,0
"176,1",2022-04-15,Winnipeg Jets,0,Florida Panthers,0,0,0,0
"177,0",2022-04-16,Pittsburgh Penguins,0,Boston Bruins,0,0,0,0
"177,1",2022-04-16,Detroit Red Wings,0,New York Rangers,0,0,0,0
"177,2",2022-04-16,Minnesota Wild,0,St. Louis Blues,0,0,0,0
"177,3",2022-04-16,Chicago Blackhawks,0,Nashville Predators,0,0,0,0
"177,4",2022-04-16,Philadelphia Flyers,0,Buffalo Sabres,0,0,0,0
"177,5",2022-04-16,Washington Capitals,0,Montréal Canadiens,0,0,0,1
"177,6",2022-04-16,Toronto Maple Leafs,0,Ottawa Senators,0,0,0,0
"177,7",2022-04-16,Winnipeg Jets,0,Tampa Bay Lightning,0,0,1,0
"177,8",2022-04-16,San Jose Sharks,0,Dallas Stars,0,0,0,0
"177,9",2022-04-16,Carolina Hurricanes,0,Colorado Avalanche,0,0,0,0
"177,10",2022-04-16,Vegas Golden Knights,0,Edmonton Oilers,0,0,0,0
"177,11",2022-04-16,Arizona Coyotes,0,Calgary Flames,0,0,0,0
"177,12",2022-04-16,New Jersey Devils,0,Seattle Kraken,0,0,0,0
"177,13",2022-04-16,Columbus Blue Jackets,0,Los Angeles Kings,0,0,0,0
"178,0",2022-04-17,Florida Panthers,0,Detroit Red Wings,0,0,0,1
"178,1",2022-04-17,Buffalo Sabres,0,Philadelphia Flyers,0,0,1,1
"178,2",2022-04-17,St. Louis Blues,0,Nashville Predators,0,0,1,1
"178,3",2022-04-17,San Jose Sharks,0,Minnesota Wild,0,0,1,1
"178,4",2022-04-17,Toronto Maple Leafs,0,New York Islanders,0,0,1,0
"178,5",2022-04-17,Columbus Blue Jackets,0,Anaheim Ducks,0,0,1,0
"179,0",2022-04-18,Washington Capitals,0,Colorado Avalanche,0,0,0,0
"179,1",2022-04-18,Dallas Stars,0,Vancouver Canucks,0,0,0,0
"179,2",2022-04-18,Carolina Hurricanes,0,Arizona Coyotes,0,0,0,0
"179,3",2022-04-18,New Jersey Devils,0,Vegas Golden Knights,0,0,0,0
"180,0",2022-04-19,Philadelphia Flyers,0,Toronto Maple Leafs,0,0,0,0
"180,1",2022-04-19,Minnesota Wild,0,Montréal Canadiens,0,0,0,0
"180,2",2022-04-19,Detroit Red Wings,0,Tampa Bay Lightning,0,0,0,0
"180,3",2022-04-19,Winnipeg Jets,0,New York Rangers,0,0,0,0
"180,4",2022-04-19,Florida Panthers,0,New York Islanders,0,0,0,0
"180,5",2022-04-19,Boston Bruins,0,St. Louis Blues,0,0,0,0
"180,6",2022-04-19,Los Angeles Kings,0,Anaheim Ducks,0,0,0,0
"180,7",2022-04-19,Columbus Blue Jackets,0,San Jose Sharks,0,0,0,0
"181,0",2022-04-20,Ottawa Senators,0,Buffalo Sabres,0,0,0,0
"181,1",2022-04-20,Dallas Stars,0,Edmonton Oilers,0,0,0,0
"181,2",2022-04-20,Chicago Blackhawks,0,Arizona Coyotes,0,0,0,0
"181,3",2022-04-20,Washington Capitals,0,Vegas Golden Knights,0,0,0,0
"181,4",2022-04-20,Colorado Avalanche,0,Seattle Kraken,0,0,0,0
"182,0",2022-04-21,Philadelphia Flyers,0,Montréal Canadiens,0,0,0,0
"182,1",2022-04-21,Detroit Red Wings,0,Florida Panthers,0,0,0,0
"182,2",2022-04-21,Buffalo Sabres,0,New Jersey Devils,0,0,1,0
"182,3",2022-04-21,Boston Bruins,0,Pittsburgh Penguins,0,0,0,0
"182,4",2022-04-21,Winnipeg Jets,0,Carolina Hurricanes,0,0,0,0
"182,5",2022-04-21,New York Rangers,0,New York Islanders,0,0,0,0
"182,6",2022-04-21,Toronto Maple Leafs,0,Tampa Bay Lightning,0,0,0,0
"182,7",2022-04-21,Vancouver Canucks,0,Minnesota Wild,0,0,0,0
"182,8",2022-04-21,Dallas Stars,0,Calgary Flames,0,0,1,0
"182,9",2022-04-21,Chicago Blackhawks,0,Los Angeles Kings,0,0,1,0
"182,10",2022-04-21,St. Louis Blues,0,San Jose Sharks,0,0,0,0
"183,0",2022-04-22,Ottawa Senators,0,Columbus Blue Jackets,0,0,0,0
"183,1",2022-04-22,Seattle Kraken,0,Minnesota Wild,0,0,0,1
"183,2",2022-04-22,Colorado Avalanche,0,Edmonton Oilers,0,0,0,0
"183,3",2022-04-22,Washington Capitals,0,Arizona Coyotes,0,0,0,0
"184,0",2022-04-23,New York Islanders,0,Buffalo Sabres,0,0,0,0
"184,1",2022-04-23,Pittsburgh Penguins,0,Detroit Red Wings,0,0,0,0
"184,2",2022-04-23,Carolina Hurricanes,0,New Jersey Devils,0,0,0,0
"184,3",2022-04-23,New York Rangers,0,Boston Bruins,0,0,0,0
"184,4",2022-04-23,Montréal Canadiens,0,Ottawa Senators,0,0,0,1
"184,5",2022-04-23,Nashville Predators,0,Tampa Bay Lightning,0,0,0,0
"184,6",2022-04-23,Toronto Maple Leafs,0,Florida Panthers,0,0,0,0
"184,7",2022-04-23,Seattle Kraken,0,Dallas Stars,0,0,1,0
"184,8",2022-04-23,Chicago Blackhawks,0,San Jose Sharks,0,0,0,0
"184,9",2022-04-23,Vancouver Canucks,0,Calgary Flames,0,0,0,0
"184,10",2022-04-23,St. Louis Blues,0,Arizona Coyotes,0,0,0,1
"184,11",2022-04-23,Anaheim Ducks,0,Los Angeles Kings,0,0,0,0
"185,0",2022-04-24,Detroit Red Wings,0,New Jersey Devils,0,0,1,1
"185,1",2022-04-24,Carolina Hurricanes,0,New York Islanders,0,0,1,1
"185,2",2022-04-24,Boston Bruins,0,New York Rangers,0,0,1,1
"185,3",2022-04-24,Edmonton Oilers,0,Columbus Blue Jackets,0,0,0,0
"185,4",2022-04-24,Pittsburgh Penguins,0,Philadelphia Flyers,0,0,1,0
"185,5",2022-04-24,Tampa Bay Lightning,0,Florida Panthers,0,0,1,1
"185,6",2022-04-24,Toronto Maple Leafs,0,Washington Capitals,0,0,1,0
"185,7",2022-04-24,Colorado Avalanche,0,Winnipeg Jets,0,0,0,0
"185,8",2022-04-24,Minnesota Wild,0,Nashville Predators,0,0,0,1
"185,9",2022-04-24,St. Louis Blues,0,Anaheim Ducks,0,0,1,1
"185,10",2022-04-24,San Jose Sharks,0,Vegas Golden Knights,0,0,1,0
"186,0",2022-04-25,Philadelphia Flyers,0,Chicago Blackhawks,0,0,1,0
"187,0",2022-04-26,Florida Panthers,0,Boston Bruins,0,0,0,0
"187,1",2022-04-26,Buffalo Sabres,0,Montréal Canadiens,0,0,0,0
"187,2",2022-04-26,New Jersey Devils,0,Ottawa Senators,0,0,0,0
"187,3",2022-04-26,Columbus Blue Jackets,0,Tampa Bay Lightning,0,0,0,0
"187,4",2022-04-26,Carolina Hurricanes,0,New York Rangers,0,0,0,0
"187,5",2022-04-26,Edmonton Oilers,0,Pittsburgh Penguins,0,0,0,0
"187,6",2022-04-26,New York Islanders,0,Washington Capitals,0,0,0,0
"187,7",2022-04-26,Toronto Maple Leafs,0,Detroit Red Wings,0,0,0,0
"187,8",2022-04-26,Calgary Flames,0,Nashville Predators,0,0,0,0
"187,9",2022-04-26,Arizona Coyotes,0,Minnesota Wild,0,0,0,0
"187,10",2022-04-26,Vegas Golden Knights,0,Dallas Stars,0,0,0,0
"187,11",2022-04-26,St. Louis Blues,0,Colorado Avalanche,0,0,0,0
"187,12",2022-04-26,Seattle Kraken,0,Vancouver Canucks,0,0,0,0
"187,13",2022-04-26,Anaheim Ducks,0,San Jose Sharks,0,0,0,0
"188,0",2022-04-27,Philadelphia Flyers,0,Winnipeg Jets,0,0,0,0
"188,1",2022-04-27,Vegas Golden Knights,0,Chicago Blackhawks,0,0,1,0
"188,2",2022-04-27,Arizona Coyotes,0,Dallas Stars,0,0,1,1
"188,3",2022-04-27,Los Angeles Kings,0,Seattle Kraken,0,0,0,1
"189,0",2022-04-28,Buffalo Sabres,0,Boston Bruins,0,0,0,0
"189,1",2022-04-28,Florida Panthers,0,Ottawa Senators,0,0,0,0
"189,2",2022-04-28,Tampa Bay Lightning,0,New York Islanders,0,0,0,0
"189,3",2022-04-28,Columbus Blue Jackets,0,Washington Capitals,0,0,0,0
"189,4",2022-04-28,New Jersey Devils,0,Carolina Hurricanes,0,0,0,0
"189,5",2022-04-28,Calgary Flames,0,Minnesota Wild,0,0,0,0
"189,6",2022-04-28,Nashville Predators,0,Colorado Avalanche,0,0,0,0
"189,7",2022-04-28,San Jose Sharks,0,Edmonton Oilers,0,0,0,0
"189,8",2022-04-28,Los Angeles Kings,0,Vancouver Canucks,0,0,1,0
"190,0",2022-04-29,Chicago Blackhawks,0,Buffalo Sabres,0,0,0,1
"190,1",2022-04-29,Boston Bruins,0,Toronto Maple Leafs,0,0,1,0
"190,2",2022-04-29,Florida Panthers,0,Montréal Canadiens,0,0,1,0
"190,3",2022-04-29,Detroit Red Wings,0,New Jersey Devils,0,0,0,1
"190,4",2022-04-29,Washington Capitals,0,New York Rangers,0,0,1,0
"190,5",2022-04-29,Ottawa Senators,0,Philadelphia Flyers,0,0,1,0
"190,6",2022-04-29,Carolina Hurricanes,0,Pittsburgh Penguins,0,0,1,0
"190,7",2022-04-29,Tampa Bay Lightning,0,Columbus Blue Jackets,0,0,1,1
"190,8",2022-04-29,Vegas Golden Knights,0,St. Louis Blues,0,0,0,0
"190,9",2022-04-29,Colorado Avalanche,0,Minnesota Wild,0,0,1,1
"190,10",2022-04-29,Calgary Flames,0,Winnipeg Jets,0,0,1,0
"190,11",2022-04-29,Anaheim Ducks,0,Dallas Stars,0,0,0,0
"190,12",2022-04-29,Vancouver Canucks,0,Edmonton Oilers,0,0,1,1
"190,13",2022-04-29,San Jose Sharks,0,Seattle Kraken,0,0,1,0
"190,14",2022-04-29,Nashville Predators,0,Arizona Coyotes,0,0,1,0
